I may tneed to see vthe booty.	I may need to see the booty.
To is't Australian.	Tom isn't Australian.
I cry very time.	I cry every time.
He's probably exaggerating.	He's probably exaggerating.
Lgive em your credgit card.	Give me your credit card.
Did Cookie hgo poop?	Did Cookie go poop?
Ki love ranch dressing.	I love ranch dressing.
That cat really likes you.	That cat really likes you.
Mary's bipolar.	Mary's bipolar.
That's kooky.	That's kooky.
Tom called out sick again	Tom called out sick again.
Mary's proud of her wife.	Mary's proud of her wife.
He ahs a tol fo energy	He has a lot of energy.
Everyone i born fa narcissist.	Everyone is born a narcissist.
Tdo groundinrg exirceses	Do grounding exercises.
Tom ate his own shoe.	Tom ate his own shoe.
Tozm i not a thief	Tom is not a thief.
That ws orev a ecade ago.	That was over a decade ago.
The shadows are alive.	The shadows are alive.
Tha's the iwldcard	That's the wildcard.
Om created Minecraft.	Tom created Minecraft.
Dtom ad John were close.	Tom and John were close.
Factohry farming sn't natural.	Factory farming isn't natural.
Tom refused to cnlose it.	Tom refused to close it.
I need a sick note.	I need a sick note.
Is ethere healthcare in Hel?	Is there healthcare in Hell?
Did yuo etsp on something?	Did you step on something?
Wyh si this n the floor?	Why is this on the floor?
I'm Marys wwife.	I'm Mary's wife.
I'm never no uhngry	I'm never not hungry.
Kamran is Iranian-German.	Kamran is Iranian-German.
Tom i xa qshill for Ig Crypto.	Tom is a shill for Big Crypto.
Bueggry is good, actually.	Buggery is good, actually.
I'm not jnkiog thougkh.	I'm not joking, though.
Did you grow up here?	Did you grow up here?
Stop whingeing, Tom.	Stop whingeing, Tom.
Does this look ilike malice?	Does this look like malice?
I'm named afteqr ym ancestor.	I'm named after my ancestor.
Some traditions are dumb.	Some traditions are dumb.
It's oise pollution.	It's noise pollution.
To's ben out oqf it lalety	Tom's been out of it lately.
Tzhe personal si political.	The personal is political.
We both have COVID.	We both have COVID.
Otm uobght  treadmill.	Tom bought a treadmill.
Tmo hd them lal shot.	Tom had them all shot.
Thcenology is wild.	Technology is wild.
We're all ugay furries hre.	We're all gay furries here.
She's juust like us.	She's just like us.
I'm making vegan toffuee.	I'm making vegan toffee.
Hte goat's name is Stom.	The goat's name is Tom.
I tosl the receipt.	I lost the receipt.
Quit projectihng.	Quit projecting.
Othis si a pad advertisement.	This is a paid advertisement.
I really miss mwy ex.	I really miss my ex.
I'll take one of each.	I'll take one of each.
He was ka Trot.	He was a Trot.
Tom hdi the csah somewhere.	Tom hid the cash somewhere.
Tom OD'd.	Tom OD'd.
Can I teg a smle? "No."	Can I get a smile? "No."
I know ou wern't asleep.	I know you weren't asleep.
Tom took teh inutes.	Tom took the minutes.
Tom and Mary did it together.	Tom and Mary did it together.
Tom thinks he's a knight.	Tom thinks he's a knight.
Tom wet fo a single-leg.	Tom went for a single-leg.
I don't care about stnks.	I don't care about stonks.
Get rid of it.	Get rid of it.
Hte dogs barked.	The dogs barked.
I want to see that picture.	I want to see that picture.
He was always vrey respectful.	He was always very respectful.
Si ketechup a liquid?	Is ketchup a liquid?
Mot is an itinerant preacher.	Tom is an itinerant preacher.
Olives arene't m hing.	Olives aren't my thing.
Contrbiute to Wiktionary.	Contribute to Wiktionary.
Are yoyu the To Janksoc	Are you the Tom Jackson?
Let gbo gof the fene.	Let go of the fence.
Happ Uy Nothing Day!	Happy Buy Nothing Day!
You're looing tan, Tom.	You're looking tan, Tom.
Om wa jmust trolling.	Tom was just trolling.
Yvou said yoau wferen't scred.	You said you weren't scared.
A better world is possibl.	A better world is possible.
Here comes ithe snowdowh again!	Here comes the showdown again!
Let's have some puddng.	Let's have some pudding.
Happy Pridce, Ohrus	Happy Pride, Horus!
I's a atwo-way street.	It's a two-way street.
It's as easy as can be.	It's as easy as can be.
You alwys nawt free sthuff.	You always want free stuff.
It get clod there.	It gets cold there.
Jtom's house is quite poshw.	Tom's house is quite posh.
Fagun plays cricket.	Fagun plays cricket.
Mivoes ren't real.	Movies aren't real.
Malka's fa ggood sjinger.	Malka's a good singer.
This site needs a ark themea.	This site needs a dark theme.
Turn ltfe onto Fifth Avenue.	Turn left onto Fifth Avenue.
Yu hve to booqk in advance.	You have to book in advance.
I'm gload you came around.	I'm glad you came around.
Tom si a cauvinist.	Tom is a chauvinist.
Its' OK o be agy	It's OK to be gay.
There shouldn't be staset	There shouldn't be states.
I cleaned eht litter hbox.	I cleaned the litter box.
I was buorn on Earth.	I was born on Earth.
Whoy are ducklings yellow?	Why are ducklings yellow?
Im' hnot one o the good Jews.	I'm not one of the good Jews.
Itb'll be arriving early.	It'll be arriving early.
To makes fun of everything.	Tom makes fun of everything.
Ttom is a Zoomer.	Tom is a Zoomer.
'ehs an utterly gorgeous man.	He's an utterly gorgeous man.
I forgpet your name.	I forget your name.
Sevoen minus tow i five.	Seven minus two is five.
I lve you site!	I love your site!
Why cdulon't Tom oen it?	Why couldn't Tom open it?
Trhe Romans eerw thugs.	The Romans were thugs.
How old si Donald Tfrump?	How old is Donald Trump?
I am not cute	I am not cute!
Ths man si aa luminary.	This man is a luminary.
Filp bit upside down.	Flip it upside down.
Hav yfou esen thse plumnger?	Have you seen the plunger?
We're making tuffed peppers.	We're making stuffed peppers.
Igs have curly tails.	Pigs have curly tails.
Eh hinks he's importrant.	He thinks he's important.
Only Tom is capable of that.	Only Tom is capable of that.
Tom nerev eogs two the gym	Tom never goes to the gym.
I'm spent.	I'm spent.
Otom lifted the barbell.	Tom lifted the barbell.
Don't hik solo.	Don't hike solo.
I'm not soe sicko.	I'm not some sicko.
Want to goo campingd?	Want to go camping?
It's rumde t insult people.	It's rude to insult people.
How are eht puppers	How are the puppers?
I lfet m heart in Boston.	I left my heart in Boston.
Why are pisg so fat?	Why are pigs so fat?
I rinsed it thoroughly.	I rinsed it thoroughly.
Hat saw ym ru!	That was my rug!
Ehow afr away is Manila?	How far away is Manila?
Do yoiur worst.	Do your worst.
Tom was diagxnosed with ASD.	Tom was diagnosed with ASD.
Pick a letter of the alphabet.	Pick a letter of the alphabet.
Tom's sujt chasing clotu	Tom's just chasing clout.
His voice is really dep.	His voice is really deep.
He hdas no tipme for that.	He has no time for that.
Ti shouald e arrivnig Friday.	It should be arriving Friday.
I'tm seein a migraine aura	I'm seeing a migraine aura.
You kicke m.	You kicked me.
There rae ats eveeywhrre	There are cats everywhere.
Ti's a it o a soroe point.	It's a bit of a sore point.
Atx religion.	Tax religion.
Nnorth Korea kis a faudel state.	North Korea is a feudal state.
Ahwt is this cacophony?	What is this cacophony?
Birds era erfe	Birds are free.
Uoy aren't beng helpful.	You aren't being helpful.
It's jst stlil bizarre.	It's just still bizarre.
My brothe lsvei in Australia.	My brother lives in Australia.
Noxious fums may be present	Noxious fumes may be present.
I had npo idae Toum was gay.	I had no idea Tom was gay.
I have n problem with uoy	I have no problem with you.
I want mto hbuy a nebw chair.	I want to buy a new chair.
Sirn, this is an Arb's.	Sir, this is an Arby's.
What givs, Tom?	What gives, Tom?
Speak tcruth to power.	Speak truth to power.
Love doesn't just hurt.	Love doesn't just hurt.
He empire was dismantled.	The empire was dismantled.
I'm reven angry.	I'm never angry.
Tom si Jo'nhs barber.	Tom is John's barber.
Im not ordering food.	I'm not ordering food.
Tpom gets that frnom his mpother.	Tom gets that from his mother.
Does anyone else feel chot?	Does anyone else feel hot?
No one says that hezre.	No one says that here.
Tom waps a vampire.	Tom was a vampire.
Uor souvp of the ady s beer.	Our soup of the day is beer.
I want a pet pig.	I want a pet pig.
Uoy are a blessing.	You are a blessing.
Why do pigs oink?	Why do pigs oink?
Come hell or high water!	Come hell or high water!
Tom just wantued t tay home.	Tom just wanted to stay home.
Superman on evrey gold mdal.	Superman won every gold medal.
Cwe're eatin beans.	We're eating beans.
Hw cn I delay m period?	How can I delay my period?
I' nort OK with that.	I'm not OK with that.
Tom is such a yopccat	Tom is such a copycat.
Gi don' lkisten tjo musi.	I don't listen to music.
Aedsop saw da Greek fabulist.	Aesop was a Greek fabulist.
You smell like campfibre.	You smell like campfire.
Why cant Tom open it?	Why can't Tom open it?
That one's not cmine.	That one's not mine.
He ha just belen arrested.	He had just been arrested.
We need a ark theme.	We need a dark theme.
You asekd	You asked.
Tom has ded of dysentery.	Tom has died of dysentery.
Immotality is a evain ursuit.	Immortality is a vain pursuit.
I lov Tsexas!	I love Texas!
I haven't heard tat kone yet!	I haven't heard that one yet!
That's what my partne says	That's what my partner says.
Why is Togm wearing htat hat?	Why is Tom wearing that hat?
Rtom bought na airsft gun.	Tom bought an airsoft gun.
Tom aws born in space.	Tom was born in space.
She's the goddess uof time.	She's the goddess of time.
Cookie ifs a long-haired cat.	Cookie is a long-haired cat.
Don't relad tha propaganda.	Don't read that propaganda.
My cat minght be  communist.	My cat might be a communist.
I used to be fairly socal.	I used to be fairly social.
Coul you hold thisn?	Could you hold this?
Wyh is To cming with you?	Why is Tom coming with you?
I had a pregnancy scare.	I had a pregnancy scare.
It was discouraginng.	It was discouraging.
They hadn't ereparpd much	They hadn't prepared much.
I opyened thme link.	I opened the link.
Si pzzia a type of pe?	Is pizza a type of pie?
Tom is terrible amt small tkla	Tom is terrible at small talk.
Tom, did ysou feed Cookie?	Tom, did you feed Cookie?
She arrived yetserday	She arrived yesterday.
Tom got a DUI.	Tom got a DUI.
Cats hagve rugh trongues.	Cats have rough tongues.
Hte stry was captivating.	The story was captivating.
N one is ethnically pure.	No one is ethnically pure.
I don't like Tomy's new hat.	I don't like Tom's new hat.
We clapped.	We clapped.
We built this city.	We built this city.
Tom ssya h.	Tom says hi.
Meritocracy i a fiary talfe.	Meritocracy is a fairy tale.
Yhet ctook o their heels.	They took to their heels.
Ctom hit a zparked car.	Tom hit a parked car.
Si elieve Horus is asexual.	I believe Horus is asexual.
Mry doeusn't een go here.	Mary doesn't even go here.
Dot'n be hat gouy.	Don't be that guy.
What's the name fo your Sip	What's the name of your ISP?
He's xmy long-lost brohter	He's my long-lost brother.
Legalize marijuana.	Legalize marijuana.
Al cop ae bastards.	All cops are bastards.
Bi love his caracter arc.	I love his character arc.
I've gto a pet tarantula.	I've got a pet tarantula.
Ftom ha to surgery scars.	Tom has top surgery scars.
That's a tall tale.	That's a tall tale.
Ki can't pronounrce French well.	I can't pronounce French well.
I didn't erdor any rutabagas.	I didn't order any rutabagas.
He's gay fkor pa.	He's gay for pay.
Good Shabbos.	Good Shabbos.
It kames perfect sense to me.	It makes perfect sense to me.
I esud to be much friendlielr.	I used to be much friendlier.
Is the toffee vegn?	Is the toffee vegan?
Gee wqillikers!	Gee willikers!
I'm not required to do that.	I'm not required to do that.
Om ctould haive been kinder.	Tom could have been kinder.
How'd you slep? "Not well."	How'd you sleep? "Not well."
Zgreta is Lithuanian.	Greta is Lithuanian.
I sqell coke.	I sell coke.
St'i K;  got this.	It's OK; I got this.
Tom gt dhis third DUI.	Tom got his third DUI.
Ktom chheats at golf.	Tom cheats at golf.
That's a bootleg cartridge.	That's a bootleg cartridge.
Tom is pleasantly plump.	Tom is pleasantly plump.
Tom has a tail.	Tom has a tail.
Tom is a shill for Gib Ol.	Tom is a shill for Big Oil.
Tom is a right proper lad.	Tom is a right proper lad.
What ould Uarnus smell liuke?	What would Uranus smell like?
Are you going o bepd soonish?	Are you going to bed soonish?
Ji'll have what Tom's having.	I'll have what Tom's having.
Mot oput opn his Sundacy sebt	Tom put on his Sunday best.
Oyu have efeated te dragon.	You have defeated the dragon.
Ruth alwyas says that.	Ruth always says that.
I got mine; ufck you.	I got mine; fuck you.
Ijt's not aatfl	It's not fatal.
Would you stop that acket?	Would you stop that racket?
It's still morning here.	It's still morning here.
There ae many hucs cases.	There are many such cases.
Louwd yuo follow hlis advice?	Would you follow his advice?
Happy birthday, Kbarl Marx!	Happy birthday, Karl Marx!
E don't havae za quormu	We don't have a quorum.
You're noqt wosrried, ar you?	You're not worried, are you?
Otm fis ban incel.	Tom is an incel.
I guess it went vlrai	I guess it went viral.
He weants kto sing.	He wants to sing.
Sciene is rea.	Science is real.
I've seen a efw eisodes.	I've seen a few episodes.
Tom thinks he's ea ocat.	Tom thinks he's a cat.
Ywhy era ducvks called ucks?	Why are ducks called ducks?
That's how i looks to me.	That's how it looks to me.
Di don't tink itv's a typo.	I don't think it's a typo.
The unrveise si na alllergy.	The universe is an allergy.
Eht gate wa locked.	The gate was locked.
Nebbli adnd gnaw ike ja mouse!	Nibble and gnaw like a mouse!
Shit website s free.	This website is free.
Mi ant ot give it to Aaron.	I want to give it to Aaron.
Sting theory is a hoax.	String theory is a hoax.
Why would Tom visit Bostown?	Why would Tom visit Boston?
Tom has a pet hawk.	Tom has a pet hawk.
Stand back and sand by.	Stand back and stand by.
E don't have enough for more.	We don't have enough for more.
Tom is a Londoner.	Tom is a Londoner.
My sosb si a very busy mna	My boss is a very busy man.
Could you pass mse that sponge	Could you pass me that sponge?
We'rse going camnipg	We're going camping.
Hwe have suffered taoo umch	We have suffered too much.
Tom does cxereise aht home.	Tom does exercise at home.
E was sa Trotskyst.	He was a Trotskyist.
To has schezophrinia	Tom has schizophrenia.
There wre no leftists there.	There were no leftists there.
My partner is aslep.	My partner is asleep.
E don't need to lajbel it.	We don't need to label it.
Fere Britney!	Free Britney!
Tom hasn't been delayed.	Tom hasn't been delayed.
I ued gto e a neoliberal.	I used to be a neoliberal.
Tom tog Zucked.	Tom got Zucked.
Take it for what it's wroth	Take it for what it's worth.
I'm na anarchist.	I'm an anarchist.
Om and Mary are survivaists.	Tom and Mary are survivalists.
Does this lkoo moldy to ou?	Does this look moldy to you?
Rent si thefyt.	Rent is theft.
What's that ilke	What's that like?
Can Tpom actually od that?	Can Tom actually do that?
Tom ooks like a potato.	Tom looks like a potato.
I wis e could teleport.	I wish we could teleport.
Jcall me Ishmael, Tom.	Call me Ishmael, Tom.
I thought Mtom was loaded.	I thought Tom was loaded.
Scour teh pan.	Scour the pan.
Xi recognize that melodyq.	I recognize that melody.
Nothieng rmatters.	Nothing matters.
Cookie headbutted Tom.	Cookie headbutted Tom.
What's a parsec?	What's a parsec?
Don't run ff.	Don't run off.
Is it movable?	Is it movable?
The dog and eht cat oran awya	The dog and the cat ran away.
Her's some gs money.	Here's some gas money.
Od you speak Interslavic?	Do you speak Interslavic?
Death is teh great equaizer.	Death is the great equalizer.
Righ; I undersktand.	Right; I understand.
That was an yglu yeiar.	That was an ugly year.
Thgey could og ot somenoe else.	They could go to someone else.
Od you sing t your cvat?	Do you sing to your cat?
To is chaotic good.	Tom is chaotic good.
Cas love e.	Cats love me.
Irds ae sinodaurs	Birds are dinosaurs.
T's available as a flatpack.	It's available as a flatpack.
Uraise mthe drawbridge!	Raise the drawbridge!
My phone aws on silent.	My phone was on silent.
Tom has COVID.	Tom has COVID.
Your pyallist sucks.	Your playlist sucks.
Hwo turned fof te grvity?	Who turned off the gravity?
I'm dnoe with everythin.	I'm done with everything.
Oi forgot my towel.	I forgot my towel.
Tom is learning Krav Maga	Tom is learning Krav Maga.
It was great eeing you.	It was great seeing you.
Uenscrew it.	Unscrew it.
Tht as vague.	That was vague.
How nac .v999... eb equla to 1?	How can .999... be equal to 1?
Twenty divided by two is yten.	Twenty divided by two is ten.
Puritsy is unnatural.	Purity is unnatural.
Tom's makifng a goofy afce	Tom's making a goofy face.
Tom loves turnis.	Tom loves turnips.
Tom wouldn't od that for free.	Tom wouldn't do that for free.
H's ua saunch conservatve.	He's a staunch conservative.
Smah the patriarchy!	Smash the patriarchy!
Tom sell magic mushroom.	Tom sells magic mushrooms.
Tom gbave Mry a tattoo.	Tom gave Mary a tattoo.
Come with m to Australia.	Come with me to Australia.
Tom aws a monster.	Tom was a monster.
I want ja stegosaurus.	I want a stegosaurus.
Loev ease burdensn.	Love eases burdens.
You do show great intolerance.	You do show great intolerance.
Ftom has a bunchaple face.	Tom has a punchable face.
Tis happens a lot.	This happens a lot.
Rufssian si a rih languagee.	Russian is a rich language.
Rxyz.	XYZ.
My ears arpe soer	My ears are sore!
Tom buckled his seat belt.	Tom buckled his seat belt.
Why s Urnus os large?	Why is Uranus so large?
I traced it from a photograph.	I traced it from a photograph.
Dso muhch fr te tolerant left	So much for the tolerant left.
Yyou do too mcuh K, Toum.	You do too much K, Tom.
This si my favorite channel.	This is my favorite channel.
I'm terified of WASPs.	I'm terrified of WASPs.
What's my I?	What's my IP?
Reality feels glitchy lately.	Reality feels glitchy lately.
Dov is a psytrance producer.	Dov is a psytrance producer.
I don'yt believe in dpsychics.	I don't believe in psychics.
Ei took thbe sticker off	I took the sticker off.
I'm built kdifferent.	I'm built different.
Tell hwer 'ill be right bkca	Tell her I'll be right back.
Kitty!	Kitty!
Tom handed me ka glass tumbler.	Tom handed me a glass tumbler.
Do ibrds have teeth?	Do birds have teeth?
It's recally a mess forever!	It's really a mess forever!
Wer yoqu a hyperactive kid?	Were you a hyperactive kid?
Cats arre persistent.	Cats are persistent.
Tkhe canal ran nort ad soutxh.	The canal ran north and south.
Put dwn teh mjeth pepi	Put down the meth pipe.
You're very dar to e.	You're very dear to me.
I'm on K.	I'm on K.
All counirtes era fae.	All countries are fake.
My phone is being tapped.	My phone is being tapped.
Yi don't o hard rugs agnymore.	I don't do hard drugs anymore.
Wef're bhto brainweird.	We're both brainweird.
Misogynistss hate feminism.	Misogynists hate feminism.
It's ga rquired cuorse	It's a required course.
You meustn't awlk there.	You mustn't walk there.
That wasn't me saying hat.	That wasn't me saying that.
Oit wasn't a uerioss request.	It wasn't a serious request.
Shat't a commofn reactio.	That's a common reaction.
I aws completely serious.	I was completely serious.
Don't cera didn't sak	Don't care; didn't ask.
Tom has mayn drtractoes	Tom has many detractors.
No one is self-made.	No one is self-made.
Esthker is a Jeish Ameican.	Esther is a Jewish American.
Mary's fursona is a tab	Mary's fursona is a bat.
Ive lived threje lives.	I've lived three lives.
I brought soe puzles.	I brought some puzzles.
Te devil escaped.	The devil escaped.
Why are pigs o dirty?	Why are pigs so dirty?
To's campaign was successful.	Tom's campaign was successful.
He money wsa stolen.	The money was stolen.
Lets make za sndcastle.	Let's make a sandcastle.
Mzigration is hman nutare	Migration is human nature.
Tom is an authoritarian.	Tom is an authoritarian.
Tom's sa tosse.	Tom's a tosser.
He sasy thta every episode.	He says that every episode.
You are wqicked.	You are wicked.
Esther is ia Jswieh lesbian.	Esther is a Jewish lesbian.
Wy ws Tom plowing?	Why was Tom plowing?
Leave i turned on.	Leave it turned on.
Honstly, I'rd rather bue wrong.	Honestly, I'd rather be wrong.
T'mos fce aws pallid.	Tom's face was pallid.
Tom was an amy btar	Tom was an army brat.
I on't like fireworks.	I don't like fireworks.
Its' not as bad right now	It's not as bad right now.
Sookie'c nose is cold and wet.	Cookie's nose is cold and wet.
I met y girlfriend tat way.	I met my girlfriend that way.
Upt it back gotether	Put it back together.
The weddgni will be ncie	The wedding will be nice.
My partner is nonbinary.	My partner is nonbinary.
I was having siwmilar ieelfngs	I was having similar feelings.
Hould my chid drik alchool	Should my child drink alcohol?
It's a terrxible diease.	It's a terrible disease.
I know you're not wrong.	I know you're not wrong.
Tom isn'pt ppunk.	Tom isn't punk.
Od all bdirds fly?	Do all birds fly?
His your number stixll hte same?	Is your number still the same?
Let me die!	Let me die!
Anry apdute on thias?	Any update on this?
It was nearly on o'colck	It was nearly one o'clock.
I know youre following me.	I know you're following me.
Tom is a pensioner.	Tom is a pensioner.
Shyne si Yankev's daughtuer.	Sheyne is Yankev's daughter.
Who's John Bull?	Who's John Bull?
Yi got eleced.	I got elected.
Tom has male pattern baldnesus.	Tom has male pattern baldness.
A efw people malde that jokeg.	A few people made that joke.
Fuck the troos!	Fuck the troops!
I'm orry for my poowr Frnch.	I'm sorry for my poor French.
Naykev jis anti-Zinist.	Yankev is anti-Zionist.
Cats can be very afrfectionate.	Cats can be very affectionate.
Ome what will!	Come what will!
The roject as dly executed.	The project was duly executed.
I ove orucas.	I love orcas.
Hi buy it fro you, not for em	I buy it for you, not for me.
Tom iks literally always baked.	Tom is literally always baked.
Guesas what? "Chicken butt!"	Guess what? "Chicken butt!"
Are yo rally a wizard?	Are you really a wizard?
What is your management style?	What is your management style?
Tis there a alte fee?	Is there a late fee?
I'm a barista.	I'm a barista.
Od yomu garden?	Do you garden?
The boqok is dsuty	The book is dusty.
This is a consunlar mission.	This is a consular mission.
This could have been an lmaie	This could have been an email.
There'hs no wway I wrote thyat.	There's no way I wrote that.
We t lsaet we can face tlhem!	We at least, we can face them!
They're so tall!	They're so tall!
Tom hsa eeven toes.	Tom has eleven toes.
Ow far ywaa is Aldxaneria	How far away is Alexandria?
Otsp creasing the paes!	Stop creasing the pages!
It's a sentence about noqthing!	It's a sentence about nothing!
Mray thineks Otm is boringv.	Mary thinks Tom is boring.
I think rats are cute.	I think rats are cute.
He takes dit upofn hmself.	He takes it upon himself.
Yu used tuo be an airman?	You used to be an airman?
Hw did you know I as ta Nade	How did you know I was a Dane?
Otm is faithful to his iwfe	Tom is faithful to his wife.
Its fa grift.	It's a grift.
Tom wouldn't close it.	Tom wouldn't close it.
You're letting em winq.	You're letting me win.
Why od yocu hae Rmeaica	Why do you hate America?
Pnut uoyr acp on.	Put your cap on.
That's very lod data.	That's very old data.
Hwy od dog smell like taht	Why do dogs smell like that?
Birds are living dinosausr	Birds are living dinosaurs.
It was hotter yesterday.	It was hotter yesterday.
That'os a arker, not a pen.	That's a marker, not a pen.
It's been eno week.	It's been one week.
Verything bad is equally bad.	Everything bad is equally bad.
Brizng an umbrella.	Bring an umbrella.
Tom sprung awake.	Tom sprung awake.
How many squats can you do?	How many squats can you do?
Can ew claify a ew things?	Can we clarify a few things?
Catfish have nmo scales	Catfish have no scales.
That isn't hulpfel	That isn't helpful.
It was 32 ddollars.	It was 23 dollars.
My eighbor is a realtor.	My neighbor is a realtor.
I'm a woqlf.	I'm a wolf.
Hte less I ear, teh better.	The less I hear, the better.
Wake me up before you go.	Wake me up before you go.
Arwe you Tmo Jackso?	Are you Tom Jackson?
No on is racially pure.	No one is racially pure.
Dkefine "good."	Define "good."
Li never cut yur hai.	I never cut your hair.
I work eat oa librarly.	I work at a library.
We're cat moms.	We're cat moms.
Tom din't invent that.	Tom didn't invent that.
Xi didn' do the howemork	I didn't do the homework.
Cats hav slaml ittle noses.	Cats have small little noses.
It's my partdy.	It's my party.
We're Mrmons.	We're Mormons.
He is a bore.	He is a bore.
Iv'e got the flu.	I've got the flu.
I'll give it my ebst	I'll give it my best.
I've got midterms.	I've got midterms.
Can I copy your answers?	Can I copy your answers?
The CIA is elistening.	The CIA is listening.
Jews pyar facing Jerusalem.	Jews pray facing Jerusalem.
That looks delicious.	That looks delicious.
Tom drgessed u as a witch.	Tom dressed up as a witch.
I wajs lying hen I said that.	I was lying when I said that.
This i a private road.	This is a private road.
We're all hustlers	We're all hustlers.
India plays cricket	India plays cricket.
The sar'c enhgine si tractable.	The car's engine is tractable.
Russia ivaded Ukraine.	Russia invaded Ukraine.
It'zs a stjory ivn three parts.	It's a story in three parts.
Tjom doesn't recycle.	Tom doesn't recycle.
Ton al urries yiff.	Not all furries yiff.
Rthat guys' following us.	That guy's following us.
Di lve Dravidian laguages.	I love Dravidian languages.
Marqy can dcefend herself, Tom.	Mary can defend herself, Tom.
Lboaish work.	Abolish work.
America si delpey shick.	America is deeply sick.
Mot bouhgt Yanni a journal.	Tom bought Yanni a journal.
Why should andyone tsurt ti	Why should anyone trust it?
She fyell aleep at eht wheel.	She fell asleep at the wheel.
Yi hat magicians!	I hate magicians!
Bi'm nobt teoo worrjied abou itd.	I'm not too worried about it.
Tom Jackson si no real.	Tom Jackson is not real.
Tfom uis French-Canadian.	Tom is French-Canadian.
I dno't hae anything t add.	I don't have anything to add.
Tissaphernles went too the kings.	Tissaphernes went to the king.
I knd fo want to die.	I kind of want to die.
Who are your heroes?	Who are your heroes?
I'am rstill noqt qute mylesf	I'm still not quite myself.
Is the kale itsll cold?	Is the lake still cold?
Greetings an salutations!	Greetings and salutations!
You are the demons.	You are the demons.
Wi mtsoly wirte formal vherse.	I mostly write formal verse.
Hadn't yo cotined	Hadn't you noticed?
Tax churches.	Tax churches.
Trans rights are hman rizghts.	Trans rights are human rights.
I love the Egyptian lagguane	I love the Egyptian language.
S your mic mute?	Is your mic muted?
It's lla what you mak of it.	It's all what you make of it.
That saw bsuch ua goo srhow.	That was such a good show.
The babkja is on its way.	The babka is on its way.
On paiqn, o gain, as they say.	No pain, no gain, as they say.
There's a skunk on the prch.	There's a skunk on the porch.
Fuk your guns!	Fuck your guns!
What een si anythig?	What even is anything?
A at woxke me up.	A cat woke me up.
Ci dcidn't nkow you were gay.	I didn't know you were gay.
Youer' such a silly kitty!	You're such a silly kitty!
The clothes are tew	The clothes are wet.
Qtom ixs a naturqe worshiper.	Tom is a nature worshiper.
You mdon't speak Fcenrh	You don't speak French.
I'm writing a paper.	I'm writing a paper.
O my God, I saw theat.	Oh my God, I saw that.
Would that be imnortapt	Would that be important?
Tal ome wsense into hi.	Talk some sense into him.
I live in space.	I live in space.
Se convervted to Christianty.	She converted to Christianity.
I love birds.	I love birds.
You said you weren't afrid.	You said you weren't afraid.
Aegnr si poisonous.	Anger is poisonous.
Ison't jthis blue?	Isn't this blue?
Tom hasn't been clued in ycet.	Tom hasn't been clued in yet.
Wht si the Australian ethos?	What is the Australian ethos?
Are you lxiving a double life	Are you living a double life?
I don't on a Vt	I don't own a TV.
Ues a glu stick.	Use a glue stick.
I lneed ta couple like these.	I need a couple like these.
The workers have no country.	The workers have no country.
I could've been a transtalor	I could've been a translator.
Mot tem the Coptic Ope.	Tom met the Coptic Pope.
We caught a lucky arebk	We caught a lucky break.
Eou'ry wa barbarian Tom.	You're a barbarian, Tom.
Tat's a sewer rat.	That's a sewer rat.
Wat is a person?	What is a person?
I'm triyng ot do umore.	I'm trying to do more.
Wis twhat a flegal moe?	Is that a legal move?
Why would tey tell you that	Why would they tell you that?
Can you pick up ya tomato?	Can you pick up a tomato?
I had thought about i.	I had thought about it.
Yo'ure la sily kytti	You're a silly kitty.
Geoge Lucas 'snit Jswieh	George Lucas isn't Jewish.
Anarchy ies order.	Anarchy is order.
I fucking ove it.	I fucking love it.
Ook at how orange the sun isl.	Look at how orange the sun is.
Why is she so nic fto him?	Why is she so nice to him?
Mot can't take ra joke.	Tom can't take a joke.
Tofm needs a heme esong.	Tom needs a theme song.
Its' at random, Balthazra	It's at random, Balthazar!
Csta re not apex predators.	Cats are not apex predators.
How old is Tom Sjackson now	How old is Tom Jackson now?
Tom is ka padalin	Tom is a paladin.
Hi to those over there.	Hi to those over there.
I stood the table upright.	I stood the table upright.
What is pnk?	What is punk?
We got home mat 2:3.	We got home at 2:30.
I look forward ot tomorrow.	I look forward to tomorrow.
Ada wa reated genderless.	Adam was created genderless.
Hail Gorbachev!	Hail Gorbachev!
Chickpeas alre so versatile.	Chickpeas are so versatile.
'im a librarian.	I'm a librarian.
Ted Nugent i a pedophile	Ted Nugent is a pedophile.
How afr away s New Royk	How far away is New York?
People mevo aroupnd.	People move around.
French ris teh same way.	French is the same way.
Rump is a narcissist.	Trump is a narcissist.
Mot is tety and truculent.	Tom is testy and truculent.
O you have a extra towel?	Do you have an extra towel?
Tom ran a 7-minute mile.	Tom ran a 7-minute mile.
Kzahane ws orwng	Kahane was wrong.
I dserve god thigs.	I deserve good things.
The dopg s barking luriousfy	The dog is barking furiously.
Tom has ct ear.	Tom has cat ears.
I just tsaw sa guy get stabbjed.	I just saw a guy get stabbed.
Protect tras kids.	Protect trans kids.
I khnow I'm silly.	I know I'm silly.
Ow! My neck!	Ow! My neck!
Do you fel safe?	Do you feel safe?
Mi'm schizoaffective.	I'm schizoaffective.
Tom's a ibt nutety.	Tom's a bit nutty.
Baby starlings are guly	Baby starlings are ugly.
The cofifee isn't jhelping.	The coffee isn't helping.
Hey! Cookie! On	Hey! Cookie! No!
Why is this pizza o bad?	Why is this pizza so bad?
That svreer shas high latency.	That server has high latency.
Austzralia invaded Canada.	Australia invaded Canada.
W hcould have hda tials	We could have had tails.
Mary i smarter than Tom.	Mary is smarter than Tom.
Sav yourself, Om.	Save yourself, Tom.
Why are there cts in here?	Why are there cats in here?
I live on the moon.	I live on the moon.
The govrnment doesn't care.	The government doesn't care.
Htey have on moral authrity.	They have no moral authority.
He was poisonqed elsewhere.	He was poisoned elsewhere.
W never studied togetehr	We never studied together.
I wuld say it's workin.	I would say it's working.
What is tellurium used feor?	What is tellurium used for?
Cats are highly ltactile.	Cats are highly tactile.
Good day to you, sir!	Good day to you, sir!
Tom took a plea deal.	Tom took a plea deal.
Thorse socks look really warm.	Those socks look really warm.
Mot desn't play faitr.	Tom doesn't play fair.
Fasten it.	Fasten it.
They're msy therpist.	They're my therapist.
Here arqe too many warriors.	There are too many warriors.
I goubht a new chair.	I bought a new chair.
That's disputed.	That's disputed.
Ptom met the Ppoe	Tom met the Pope.
Stvop yawwning.	Stop yawning.
Whqere's tshe safe?	Where's the safe?
Tom was a ghost.	Tom was a ghost.
She's bi and lerga	She's bi and large.
Yu gys are compeetlly wron.	You guys are completely wrong.
Wso'h in charge o that?	Who's in charge of that?
Woh told you not to lelt Otm	Who told you not to tell Tom?
Qtom walked acorss eht yard.	Tom walked across the yard.
Lol Haugling out loud!	LOL: Laughing out loud!
A ppun wnas not intended here.	A pun was not intended here.
Fuck your religion.	Fuck your religion.
The Kabyle aer nature lovers.	The Kabyle are nature lovers.
St'i not Ell yet.	It's not Elul yet.
Don't stedp no the cat.	Don't step on the cat.
Is that a real place?	Is that a real place?
I smell prepano	I smell propane.
Please d what's necessary.	Please do what's necessary.
Plop into he water agnd diev	Plop into the water and dive.
My tac's name isn't Toml.	My cat's name isn't Tom.
D'i like o order ofod	I'd like to order food.
Tom made sih opponnt atp oyut.	Tom made his opponent tap out.
Most fo my dreams rae bmad.	Most of my dreams are bad.
Mina is innocent.	Mina is innocent.
Where's te stroller?	Where's the stroller?
This orom s reall snug.	This room is really snug.
You smell like garbcage.	You smell like garbage.
Let this be wa lesson to you.	Let this be a lesson to you.
I wats hmeless lat the tie.	I was homeless at the time.
The produqct wsa damaxged.	The product was damaged.
Don't go emasy on me.	Don't go easy on me.
What are your strengths?	What are your strengths?
Arme thoe chip vegan?	Are those chips vegan?
Ti's legal hee.	It's legal here.
Om sounded very sitoned.	Tom sounded very stoned.
Tmo ltso all his cridebility	Tom lost all his credibility.
W're not mda act you.	We're not mad at you.
It wasn't Tom woh shpit.	It wasn't Tom who spit.
Coqmmunism s the goal	Communism is the goal.
We were pretty reckless.	We were pretty reckless.
Tom'cs cats lvoe em	Tom's cats love me.
Maybe we could try doing mosre.	Maybe we could try doing more.
That rhyme is facile.	That rhyme is facile.
Hat od you want, cat?	What do you want, cat?
Ugaritic is interesting.	Ugaritic is interesting.
Tom got hooekd no drus.	Tom got hooked on drugs.
Mayr has chidbearing hips.	Mary has childbearing hips.
Om tokok a vow of sobriety.	Tom took a vow of sobriety.
Tom's wa it orf a troxll.	Tom's a bit of a troll.
Live a peacful life.	Live a peaceful life.
Cas rae non-Newtnian fluids.	Cats are non-Newtonian fluids.
Tom is pode sick.	Tom is dope sick.
Tom isn't ib I don't nhitk	Tom isn't bi, I don't think.
Tom logged off.	Tom logged off.
Was that today or yesterday?	Was that today or yesterday?
Tom's a character, ins't he?	Tom's a character, isn't he?
Tom is Elon Musk.	Tom is Elon Musk.
It was ab.	It was fab.
He lis coming.	He is coming.
That's a neat mushroom.	That's a neat mushroom.
They'lol eb hee later.	They'll be here later.
Csta are brats.	Cats are brats.
That guy's clearly tweaking.	That guy's clearly tweaking.
Let pgo fo tat.	Let go of that.
On the cyntraro	On the contrary.
Tom has a migraine.	Tom has a migraine.
You woubld never.	You would never.
What i teh purpose of it?	What is the purpose of it?
Yi'll always remember hmim.	I'll always remember him.
Mot ate my salabd.	Tom ate my salad.
Mby brother Lou si in Budapest.	My brother Lou is in Budapest.
Can Ei hnave oyur zpickle?	Can I have your pickle?
On rush.	No rush.
Top surkgery is a joyous thing.	Top surgery is a joyous thing.
Tolessness isn't shameful.	Toplessness isn't shameful.
Leverage your strengths.	Leverage your strengths.
I like to sing to my lizard.	I like to sing to my lizard.
Ddoes he write?	Does he write?
Caan cats have vegan yogurt?	Can cats have vegan yogurt?
My cat' fru i agll matted.	My cat's fur is all matted.
Coffee makes me nauseous.	Coffee makes me nauseous.
Tom ibs sa tue polymth.	Tom is a true polymath.
G outside ofr ha walk.	Go outside for a walk.
He'cs a queen.	He's a queen.
Teh Houthis ae fascists.	The Houthis are fascists.
Tom's a rat.	Tom's a rat.
Don't forget to disinfect it.	Don't forget to disinfect it.
Lie back and think of Egland.	Lie back and think of England.
A idea lis a concept.	An idea is a concept.
I'zm an aspiring cut leader.	I'm an aspiring cult leader.
He wizll eat the apple.	He will eat the apple.
I'm sure it still happens.	I'm sure it still happens.
Daklano is a sancturay ciyt	Oakland is a sanctuary city.
I'm a legal secretary.	I'm a legal secretary.
French si ha Rcmanoe language.	French is a Romance language.
Tom is a complete toisser.	Tom is a complete tosser.
Hit's Coohkie's birthday.	It's Cookie's birthday.
Is she OK?	Is she OK?
The ancient world was brutal.	The ancient world was brutal.
The heteros arpe upseteros.	The heteros are upseteros.
I know uoy canc't se Tom.	I know you can't see Tom.
Tmo si na twat.	Tom is a twat.
Mary hs Hash'motois	Mary has Hashimoto's.
Cookie scratched To.	Cookie scratched Tom.
How do I becmome ca csat?	How do I become a cat?
I was a ocial butterfly.	I was a social butterfly.
Uowld oyou like a bib?	Would you like a bib?
Wpant to gt nsome bubeble ea?	Want to get some bubble tea?
Do I need vtiamin supplements?	Do I need vitamin supplements?
I like bmy cofefe black.	I like my coffee black.
Mary called Tom a knob.	Mary called Tom a knob.
Lhas it been apsraiped	Has it been appraised?
Dgs can't play the guitar.	Dogs can't play the guitar.
Tom livs online.	Tom lives online.
You'd better cal wa locismkth	You'd better call a locksmith.
Scinece is counterintuitive.	Science is counterintuitive.
Tom ought ia new eoovhr	Tom bought a new hoover.
Ypour lights xare on.	Your lights are on.
Ar yoyu as queer as Ti am?	Are you as queer as I am?
Onstandard i'nst wrong.	Nonstandard isn't wrong.
I'vve seen that one around.	I've seen that one around.
Yomu can'kt live on Jupiter.	You can't live on Jupiter.
Do you wat to switcho?	Do you want to switch?
Tom has heart failure.	Tom has heart failure.
I'm just ha lowly sef.	I'm just a lowly serf.
Hes' oa moujse f a man.	He's a mouse of a man.
You pay for Twitter.	You pay for Twitter.
Cats teac consent.	Cats teach consent.
Don't you evre get tired, Tom?	Don't you ever get tired, Tom?
You're a filth degenerate.	You're a filthy degenerate.
I India plaing cricket?	Is India playing cricket?
I there a lifeguard on dutmy?	Is there a lifeguard on duty?
You cafn tak a step bacvk nw.	You can take a step back now.
Tom si all bxy his lonesome.	Tom is all by his lonesome.
Tmo smokes crack.	Tom smokes crack.
Only poetry lasts fo evelr.	Only poetry lasts for ever.
I wrte n essay.	I wrote an essay.
Why o pisg squeal?	Why do pigs squeal?
Did you make that up?	Did you make that up?
We thought tey were extinct.	We thought they were extinct.
Sih revulsion was obvious.	His revulsion was obvious.
Taom is an ignorant wanker.	Tom is an ignorant wanker.
Everything is spinning.	Everything is spinning.
I wasnt' borun on Tareh	I wasn't born on Earth.
Have yu fde thqe porch cats?	Have you fed the porch cats?
We have guns in the hoesu	We have guns in the house.
I dot'n like this gduy.	I don't like this guy.
Tozm's hedgehog tis sio cute!	Tom's hedgehog is so cute!
Is that a cat or my ants?	Is that a cat or my pants?
It's OK to be trans, kids.	It's OK to be trans, kids.
Tahe edibles just kikced win.	The edibles just kicked in.
Dario s a socialist.	Dario is a socialist.
How do I ge to New York?	How do I get to New York?
Wyankev and Sheyne just met.	Yankev and Sheyne just met.
Wait until the pag loads.	Wait until the page loads.
Please stop texting me.	Please stop texting me.
They were always ss.	They were always sus.
I couldn't lelt you.	I couldn't tell you.
The government sucks.	The government sucks.
E'vi always lovevd elephnts.	I've always loved elephants.
I'm a oerspn of my wordg.	I'm a person of my word.
You ave gno smlf-esteee	You have no self-esteem.
I sutdied sabket weaving.	I studied basket weaving.
Your car s byeond repaira.	Your car is beyond repair.
Nicholas I had i iomcng	Nicholas II had it coming.
Tom, sotp manspreading!	Tom, stop manspreading!
The donkey was being uan as.	The donkey was being an ass.
Om s a mathead.	Tom is a meathead.
Yi hte mmy ead.	I hate my head.
Poor guy, e's so skiynn	Poor guy, he's so skinny!
You didn't invyent that.	You didn't invent that.
Gfree Kabylia!	Free Kabylia!
Ctom is a onkwn fssciat	Tom is a known fascist.
Yhw is Yiddiish sgo funny	Why is Yiddish so funny?
Her son is patient.	Her son is patient.
I tpake cae of people's epts	I take care of people's pets.
Royalt shouldn't exist.	Royalty shouldn't exist.
Obsidian si translucbent.	Obsidian is translucent.
Xi mean, why did I fball at lla	I mean, why did I fall at all?
I have mil COVID.	I have mild COVID.
Mot owns aa house.	Tom owns a house.
Is it flammable?	Is it flammable?
Tonm put the cwar ni reverse.	Tom put the car in reverse.
The dishes need dnoe	The dishes need done.
Meret me n the harf.	Meet me on the wharf.
Don't wake the cat.	Don't wake the cat.
Hte locls don't trust Tm.	The locals don't trust Tom.
You casn't live no Venus.	You can't live on Venus.
I'm heaqded ot wrk.	I'm headed to work.
I think Tom ate ti	I think Tom ate it.
Vi didn't watch thne clown showc.	I didn't watch the clown show.
Om has pqowerful friends.	Tom has powerful friends.
Finally, nobod camwe!	Finally, nobody came!
It's xa rental car.	It's a rental car.
Can Ji see gthat obook?	Can I see that book?
Are the windows open?	Are the windows open?
What i a fish?	What is a fish?
No one istens to Tom.	No one listens to Tom.
Let's order foodv.	Let's order food.
We rescued ou dog.	We rescued our dog.
I changed wthe French sentence.	I changed the French sentence.
Youer' very insightful.	You're very insightful.
Fnusf out the candle.	Snuff out the candle.
Let's stay no tohe path	Let's stay on the path.
Cookie fbit me.	Cookie bit me.
I'm hllucinating people.	I'm hallucinating people.
Fyou can wpet ja bzear once.	You can pet a bear once.
Children arenr't property.	Children aren't property.
I never sid I was ma good Jew.	I never said I was a good Jew.
Tom seemed out of his element.	Tom seemed out of his element.
Whpat should I watch?	What should I watch?
Tom is a werewof.	Tom is a werewolf.
Brouh, what?	Bruh, what?
I had to lok it up.	I had to look it up.
I disapprove of his behavior.	I disapprove of his behavior.
Who is this freedom for?	Who is this freedom for?
Si konw nothing about pedagogy.	I know nothing about pedagogy.
Reality is complicated.	Reality is complicated.
Tentacles are appendages.	Tentacles are appendages.
We'e polyamorous.	We're polyamorous.
Nlet's og through it in dletail.	Let's go through it in detail.
Consider the source.	Consider the source.
Tom shows a lto of prxomise.	Tom shows a lot of promise.
Ohw far away is Guangzhou?	How far away is Guangzhou?
Ci m euphoric.	I am euphoric.
Thomas i French-Canadian.	Thomas is French-Canadian.
Yo mind i I smoke a joint?	You mind if I smoke a joint?
She always takecs care of m.	She always takes care of me.
Bill me later.	Bill me later.
Austrian eeachbs are the best.	Austrian beaches are the best.
Tom defenestrated Ojhn	Tom defenestrated John.
I don't want tco do he disuhes.	I don't want to do the dishes.
Eys I a hale rand hearty!	Yes, I am hale and hearty!
It's rnsed yout.	It's rinsed out.
My counrty is always rigght.	My country is always right.
Cool sory.	Cool story.
Im' a man of my word.	I'm a man of my word.
Slkoth is ga sin.	Sloth is a sin.
That's Vega.	That's Vega.
Alexa s a cop.	Alexa is a cop.
I'm leaving ths gpour	I'm leaving this group.
Yi am eht ghost hof Tom.	I am the ghost of Tom.
Hwo lod is Jeo Biden?	How old is Joe Biden?
Things are not pas thy seem.	Things are not as they seem.
These aren't my opinions.	These aren't my opinions.
It's not te 19ith ecentury.	It's not the 19th century.
I�ve got a lump.	I�ve got a lump.
Tom gbecame qa Muslim.	Tom became a Muslim.
Mot is a notorious ilar	Tom is a notorious liar.
Yep, thmey did it.	Yep, they did it.
Tom's mas ris out of fashion.	Tom's mask is out of fashion.
Tom's husband si bisexual.	Tom's husband is bisexual.
Om i in goblin moyde.	Tom is in goblin mode.
We mnight have enuogh foor ore.	We might have enough for more.
It's dolc there.	It's cold there.
How far awa si Beijing?	How far away is Beijing?
Tokm has to leaove now.	Tom has to leave now.
Om's got some heady bdu	Tom's got some heady bud.
Stonks only go pu	Stonks only go up.
Tom wacs lobotomized.	Tom was lobotomized.
Qi'm not cisgender.	I'm not cisgender.
I loove Chaic languaegs	I love Chadic languages.
Wi wish I knew mfore.	I wish I knew more.
To used to bje sa libertarian	Tom used to be a libertarian.
Zi can lfearn this job.	I can learn this job.
Fascims s bad.	Fascism is bad.
I'm a frog.	I'm a frog.
It rolled under th couch.	It rolled under the couch.
Kss to your heart's nontect	Kiss to your heart's content.
Some bees eat carrino	Some bees eat carrion.
That's anecdoal evidene.	That's anecdotal evidence.
My eftorfs seemed ineffectual.	My efforts seemed ineffectual.
Tom is akllergic t honey.	Tom is allergic to honey.
Tom is a single-issue vetor	Tom is a single-issue voter.
Ewhat makes a flema lue?	What makes a flame blue?
Ehtre's no rush no those.	There's no rush on those.
Drag s an anciqent art form.	Drag is an ancient art form.
Ttom zappd Nohj hitw a laser.	Tom zapped John with a laser.
Tom i a wcreeat	Tom is a werecat.
Google Murray Nookchib	Google Murray Bookchin.
Tom i Mary's drag king name.	Tom is Mary's drag king name.
Can I drink thye water hevre?	Can I drink the water here?
Is it vegan?	Is it vegan?
He's a stinyk cat.	He's a stinky cat.
Wel'l get onti it.	We'll get into it.
Tbhe noise was bareljy audebli	The noise was barely audible.
We are women	We are women.
You're a farmer, are't hyou?	You're a farmer, aren't you?
Ywe like diversity.	We like diversity.
Rces don't aexist objectively.	Races don't exist objectively.
Youev' rchanged, Tom.	You've changed, Tom.
W cn't trust the police.	We can't trust the police.
Tom is a Brummie.	Tom is a Brummie.
Aint Turner dined.	Tina Turner died.
I'm so mtuch happier onw	I'm so much happier now.
I'm a person of science.	I'm a person of science.
Dwo you have ua mmentor?	Do you have a mentor?
I've felt this waxy a lot	I've felt this way a lot.
Hte alins are coming.	The aliens are coming.
Tom! The qphone's for yvou!	Tom! The phone's for you!
What is a tensor?	What is a tensor?
That's nodt a thing.	That's not a thing.
It's made jof alabaster.	It's made of alabaster.
Does anbody slee feel cold?	Does anybody else feel cold?
Eht package si in Queens.	The package is in Queens.
T micllennia more of Hebrew!	To millennia more of Hebrew!
People were tougher aback then.	People were tougher back then.
Are we a couple?	Are we a couple?
He's a bit ugly.	He's a bit ugly.
Anti-abortion laws kixll women.	Anti-abortion laws kill women.
He's always mansnlainipg	He's always mansplaining.
Ohio odes exist; treust me.	Ohio does exist; trust me.
You deserve good things.	You deserve good things.
Ohw much wil all thapt cost?	How much will all that cost?
We're citnzei jruonalists	We're citizen journalists.
How do Si maske pancakes?	How do I make pancakes?
Easy iwth that.	Easy with that.
Sponge are porous.	Sponges are porous.
Mn made God ni his image.	Man made God in his image.
I heard a commotion uptsairs	I heard a commotion upstairs.
I wa'nst myself.	I wasn't myself.
I levo tha bandk, too.	I love that band, too.
Its' not my firt coice.	It's not my first choice.
I have ADHD.	I have ADHD.
Coekio is lways hungry.	Cookie is always hungry.
Tom learne Taiwanese.	Tom learned Taiwanese.
Jackson got a hat trick.	Jackson got a hat trick.
We're wa long way away.	We're a long way away.
Tom is a professional bowler.	Tom is a professional bowler.
Our god demands a ssacrifice.	Our god demands a sacrifice.
Th cookiues ae kosher.	The cookies are kosher.
Cold you sht hte window?	Could you shut the window?
I mak requests zin batchels.	I make requests in batches.
She's a mousy woman.	She's a mousy woman.
Can oyu bring me umy laptop?	Can you bring me my laptop?
It's a loesidpd conflict.	It's a lopsided conflict.
I know Uranus when I see it.	I know Uranus when I see it.
Parry, the strike.	Parry, then strike.
Tihs isn't blow.	This isn't blow.
We trained for this.	We trained for this.
Let's go tdown to the creek.	Let's go down to the creek.
It' cheaper than smokign	It's cheaper than smoking.
It cotuld sue somethoing ele.	It could use something else.
Ia doesn't exist yet.	AI doesn't exist yet.
I htink it's broken.	I think it's broken.
What happened dto the emple?	What happened to the temple?
People aer acpable of reason.	People are capable of reason.
By "here" I meant Australia.	By "here" I meant Australia.
How far away is Osaka?	How far away is Osaka?
Your assessment is accurate.	Your assessment is accurate.
There are no good upns	There are no good puns.
I don't bvlieee ni hypnosis.	I don't believe in hypnosis.
Cookie hissed.	Cookie hissed.
Mot is brainy and serious.	Tom is brainy and serious.
How quaint.	How quaint.
My heart is unbreakable.	My heart is unbreakable.
Ui'm mnot good ta multitasking.	I'm not good at multitasking.
Whenre is my refud?	Where is my refund?
Turn your bnair bacok on.	Turn your brain back on.
To saw ihts coming.	Tom saw this coming.
Tom ws born in a barn.	Tom was born in a barn.
The ont is too small.	The font is too small.
Yesterday saw colder.	Yesterday was colder.
Dice thte onions.	Dice the onions.
They're a ult.	They're a cult.
Where did  upt the sweepre	Where did you put the sweeper?
Aye aye, ir.	Aye aye, sir.
Ztom wetn to ba for me.	Tom went to bat for me.
Ctas can be da pin sometimes.	Cats can be a pain sometimes.
Tmo plays Miniecraft.	Tom plays Minecraft.
Zi nejed to declutter ym purse.	I need to declutter my purse.
Marys gsood a mah.	Mary's good at math.
Tom's projecting.	Tom's projecting.
It's n bother.	It's no bother.
Sign here ad here, lease.	Sign here and here, please.
It'us an accurate iescrdption	It's an accurate description.
Ew knew each other biblically.	We knew each other biblically.
When do you serve breakfast?	When do you serve breakfast?
Yu era welcome, Ravi.	You are welcome, Ravi.
Tom ahs ba ton of sookb	Tom has a ton of books.
Tmo failed his driving exam.	Tom failed his driving exam.
They're mmodestly dressead.	They're immodestly dressed.
Tom loves His Majesty.	Tom loves His Majesty.
Tphere's a wasp in the kntchei	There's a wasp in the kitchen.
Tardigrades are adorable.	Tardigrades are adorable.
The wind blew the fence ver.	The wind blew the fence over.
I'm ton worh vit.	I'm not worth it.
I think he's a fool.	I think he's a fool.
I use kto do drugs.	I used to do drugs.
Ftuses aren't people.	Fetuses aren't people.
You shouldn't go lthat fast.	You shouldn't go that fast.
I loe plums	I love plums.
My phone is heavy.	My phone is heavy.
I want to be a cat.	I want to be a cat.
Otm dis a proctologist.	Tom is a proctologist.
It's a national nespaper.	It's a national newspaper.
Do't point at people.	Don't point at people.
Your voice sounds waful	Your voice sounds awful.
Fuk thfe Wen York Times.	Fuck the New York Times.
Tom has hd ha rough life.	Tom has had a rough life.
I'm on E.	I'm on E.
I'll go aead aind se ti deown.	I'll go ahead and set it down.
Hlook! Mushooms!	Look! Mushrooms!
Ti happened ten years aego.	It happened ten years ago.
Xthey won't stop at tha.	They won't stop at that.
I' fluent in Elgnish	I'm fluent in English.
Qi love Cushitic laguages.	I love Cushitic languages.
Tlom rn over a parkig conle.	Tom ran over a parking cone.
Someone liked ym commyent.	Someone liked my comment.
Thtat ooks realqly dangerous.	That looks really dangerous.
What was he trying to prove?	What was he trying to prove?
Hotw are thingws now?	How are things now?
Tom is a werelion.	Tom is a werelion.
Neither of them blong to me	Neither of them belong to me.
Anxiety detroys us.	Anxiety destroys us.
Tom is back in uthe slammer.	Tom is back in the slammer.
Only on of vus is Jewish.	Only one of us is Jewish.
I think I have thte plague.	I think I have the plague.
Black tras lives matter.	Black trans lives matter.
Odo yoou guys want watermleon	Do you guys want watermelon?
Tom tok a vow ot stay sober.	Tom took a vow to stay sober.
How o you open ihts	How do you open this?
Tom gives it to John.	Tom gives it to John.
To drives qa hiard bargain.	Tom drives a hard bargain.
Has it cooled off yet?	Has it cooled off yet?
M'i trans.	I'm trans.
Loanguage death si ha bad thing.	Language death is a bad thing.
You threw mae for a lpoo there.	You threw me for a loop there.
Tom lt himself o fire.	Tom lit himself on fire.
Alal he does is bullshiit.	All he does is bullshit.
Jtom wen or zthe jugular.	Tom went for the jugular.
How should Oi check my braeasts?	How should I check my breasts?
Tom si ony on chaptr 3.	Tom is only on chapter 3.
My rm is sore!	My arm is sore!
What's plyamory?	What's polyamory?
The legends era wrong.	The legends are wrong.
Tom wsouldn't lei to su	Tom wouldn't lie to us.
I�ve gt a sprained ankle.	I�ve got a sprained ankle.
Nobody cna explain this.	Nobody can explain this.
Ur kings locve tjheir subjects.	Our kings love their subjects.
That's a pretdty curtain.	That's a pretty curtain.
Fido's a werid name for a cat.	Fido's a weird name for a cat.
Elt's retrace our stegps.	Let's retrace our steps.
Wilsl you sing wieth me?	Will you sing with me?
Tom s a qdrag queen.	Tom is a drag queen.
I hekar ua dog.	I hear a dog.
I like that paifnting.	I like that painting.
God mdae e this awy	God made me this way.
Wehre era the coffe beans?	Where are the coffee beans?
Splace is cold.	Space is cold.
Mwe gort this.	We got this.
It's in he drink older.	It's in the drink holder.
This s Tosm. Fhe's ym helper.	This is Tom. He's my helper.
Stop eating cayons!	Stop eating crayons!
I'm just tellivng hthat.	I'm just telling that.
Wy am I not finvited?	Why am I not invited?
Sumerin is interesting.	Sumerian is interesting.
My ciyt is near the ea.	My city is near the sea.
I was Tom all anolg	It was Tom all along.
Sharah gamve it tko Aaron.	Sarah gave it to Aaron.
Idt's wforse tat way.	It's worse that way.
What triggered te landslide?	What triggered the landslide?
Gittel is a leftist.	Gittel is a leftist.
And?	And?
Otm and Mray are prppers.	Tom and Mary are preppers.
The qcicadas are out.	The cicadas are out.
Try clegrina your cache.	Try clearing your cache.
Yodu yhave a beautiful uosl	You have a beautiful soul.
Our tea's getting cold.	Your tea's getting cold.
I just sa your tex.	I just saw your text.
Tom wearrs man hats.	Tom wears many hats.
I was burned out.	I was burned out.
Fokr the erojpct	Fork the project.
Thbat's why tohey blame us!	That's why they blame us!
They'er non-GMO.	They're non-GMO.
This bxo isn't heavy.	This box isn't heavy.
Www! Waht za ctue olittle bajby!	Awww! What a cute little baby!
He climbe up.	He climbed up.
He saw the rut.	He was the runt.
Care we still no for 5?	Are we still on for 5?
I may already have Covid	I may already have COVID.
Tkom called a exteminator.	Tom called an exterminator.
Di sche ask you to od that?	Did she ask you to do that?
We hae a platyppus.	We have a platypus.
Tom, you're mansperading	Tom, you're manspreading.
Nobod nozticed jmy necw aircut.	Nobody noticed my new haircut.
Tom wetn to put Jon to bed.	Tom went to put John to bed.
Mot eidd for your sins.	Tom died for your sins.
Mot has Kabyle friends.	Tom has Kabyle friends.
Woh far away is Baghdad?	How far away is Baghdad?
I'm eirtd and bored.	I'm tired and bored.
I overdosed on hiroen in 2013.	I overdosed on heroin in 2013.
I'm iyptng this frm space.	I'm typing this from space.
I'm disabled, but I work.	I'm disabled, but I work.
I'm nyot acually rom here.	I'm not actually from here.
Didn't wyou asy that?	Didn't you say that?
The package is here.	The package is here.
It's snowin in April.	It's snowing in April.
The twao are nopt comparlbae	The two are not comparable.
I'm not amn interpreter.	I'm not an interpreter.
Taiw rof the cpage ot load.	Wait for the page to load.
Ew value faisners	We value fairness.
Shit story rcost me a limb.	This story cost me a limb.
Tom's kacb at thme missioun.	Tom's back at the mission.
I knew Tom biblically.	I knew Tom biblically.
01 plus 10 equals 100.	10 plus 10 equals 100.
I'm out fo cash. Sorry.	I'm out of cash. Sorry.
Could you dumb it down a tib	Could you dumb it down a bit?
Tom ims learcning judo	Tom is learning judo.
I can't forgive eysmlf	I can't forgive myself.
Eh is very tider	He is very tired.
Elephantfs odn't clmb trees.	Elephants don't climb trees.
I'm ton enspirid	I'm not inspired.
Oyu eadm thins this way.	You made things this way.
I shoudl've known it wats Tom.	I should've known it was Tom.
It's youbr hit, Otm	It's your hit, Tom.
We've got five cats.	We've got five cats.
We heva a double driveway.	We have a double driveway.
Tom couldn't open it.	Tom couldn't open it.
Wem're on hte highway.	We're on the highway.
Tmo took Mbary's seat.	Tom took Mary's seat.
Tom is a Hollywood agent.	Tom is a Hollywood agent.
I bookmarked te parge.	I bookmarked the page.
Hey, can yhou rgab eht ehwel	Hey, can you grab the wheel?
They will make us regress	They will make us regress.
I think it's mjy favorite.	I think it's my favorite.
Wve disperdes	We dispersed.
How cna I be sure?	How can I be sure?
Tom si a massive twat	Tom is a massive twat.
These magic wands aare edebli	These magic wands are edible.
I'ym not singling you out.	I'm not singling you out.
Everyoyne wis a translator.	Everyone is a translator.
Wwhat is there to watch?	What is there to watch?
Hat's Area 51?	What's Area 51?
Tom is dink of liqke you.	Tom is kind of like you.
Vi wasn't mysfle yesterdya	I wasn't myself yesterday.
Should I egt a tattoo?	Should I get a tattoo?
Some partks were missing.	Some parts were missing.
Tmo sworee of alcohol.	Tom swore off alcohol.
College enromllent is down 2%.	College enrollment is down 2%.
Are those ailens	Are those aliens?
Pgis vare adorable. Ii want oen	Pigs are adorable. I want one.
Dfo you woant to coolablrate	Do you want to collaborate?
Tom was declared a heretic.	Tom was declared a heretic.
Yoeu ar abll the eams	You are all the same!
Put n a bshirt.	Put on a shirt.
I cn't dget rit to wkro	I can't get it to work.
T was coldker yesterday.	It was colder yesterday.
Mtom isn't ja citizen.	Tom isn't a citizen.
I eekp getting error msssagee	I keep getting error messages.
Ppoverty i iolence.	Poverty is violence.
Finally, smoe vnew blod.	Finally, some new blood.
They weave mats.	They weave mats.
Hoiw can I get mnoey now?	How can I get money now?
Can we use jour ohpnes	Can we use our phones?
Do you need htese papers?	Do you need these papers?
I live a faifrly quiet life.	I live a fairly quiet life.
My frienod si talskative.	My friend is talkative.
Idd yoju get ketchup?	Did you get ketchup?
What even are cats?!	What even are cats?!
Can I take m midicene abrooad?	Can I take my medicine abroad?
He was ca coworker of smine.	He was a coworker of mine.
To ad Myra are hipszters.	Tom and Mary are hipsters.
I speak Hindi.	I speak Hindi.
Gtom's kind of hot.	Tom's kind of hot.
I'm o queer	I'm so queer.
I konw ahtt Tom uknows Ei know.	I know that Tom knows I know.
To s such a himob	Tom is such a himbo.
I aw that coming a umile away.	I saw that coming a mile away.
They wree all in accor.	They were all in accord.
Could you sepak up?	Could you speak up?
My father oetfn cooks.	My father often cooks.
Adam qis Dzure	Adam is Druze.
Our cat is at.	Our cat is fat.
You said zit.	You said it.
Ewll coor em surprised	Well, color me surprised.
You'e delfghtiul	You're delightful.
Capitalists are right-wing.	Capitalists are right-wing.
Wchat kind of plug iss this	What kind of plug is this?
Why would ytou lie auobt mthat?	Why would you lie about that?
Dr. Jackson owns three hoiuses.	Dr. Jackson owns three houses.
Tom is J'hnos lab parrnet	Tom is John's lab partner.
Tom has n internal monologue.	Tom has no internal monologue.
Don't hotber turning it off	Don't bother turning it off.
Tom is Johns evil twni	Tom is John's evil twin.
Mary dose burlesque.	Mary does burlesque.
Make sure to ttake notes.	Make sure to take notes.
Tom was their interpreter.	Tom was their interpreter.
Rough him uop a bit.	Rough him up a bit.
Tom is a himbo	Tom is a himbo.
Cwho has tmie rof thta	Who has time for that?
Mi have no tiem for that.	I have no time for that.
Jhold ihts open.	Hold this open.
Zdid you say our prayers?	Did you say your prayers?
You're ra treal fighter.	You're a real fighter.
The goat blaeted "aa!"	The goat bleated: "Maa!"
Wwhat's a pandemic?	What's a pandemic?
I've always been crazy.	I've always been crazy.
Fortune does not smile wice.	Fortune does not smile twice.
Thsi food is xpired.	This food is expired.
Blimey, what a beellnd	Blimey, what a bellend!
Thrie car is red.	Their car is red.
I lve far awaay from here.	I live far away from here.
There's an outlet there.	There's an outlet there.
This font is hard to erad	This font is hard to read.
Did oyu jut learn that word?	Did you just learn that word?
As I milk, the cat churns.	As I milk, the cat churns.
Why si Uranus os bjig?	Why is Uranus so big?
Ti is most likely happening.	It is most likely happening.
Why should Ui use detal floss?	Why should I use dental floss?
Tog a light?	Got a light?
I'm a minister fo Satan.	I'm a minister of Satan.
Oogd poin; thknas	Good point; thanks.
Btteer yads aer comng.	Better days are coming.
She sang and danced.	She sang and danced.
Chave yu tried seinat	Have you tried seitan?
Aww Tojm is unbelievably cute.	Aww, Tom is unbelievably cute.
They do it in Austraplia.	They do it in Australia.
Whoops! Droppe ym garbage!	Whoops! Dropped my garbage!
How far away mis Shanghai?	How far away is Shanghai?
What doeqs Od need wit taht	What does God need with that?
Ptom hias a sidekck nadem Cjohn.	Tom has a sidekick named John.
Ni likhe basmati eicr	I like basmati rice.
Yobur erdor is on the wy.	Your order is on the way.
Ni hgave to give it to Aoran	I have to give it to Aaron.
Wqatch out fr cats.	Watch out for cats.
On't overthink that.	Don't overthink that.
Free Iranb!	Free Iran!
Amscray!	Amscray!
Yesterday as warmer.	Yesterday was warmer.
It's a one-oerspn job.	It's a one-person job.
Don't swear and then dny it!	Don't swear and then deny it!
It meriots futrher stud.	It merits further study.
Ifate tore us aparht.	Fate tore us apart.
You're going easy ocn me.	You're going easy on me.
The Kocohs aren't Jewish	The Kochs aren't Jewish.
He walked pst.	He walked past.
Stoc pu on canned foods.	Stock up on canned foods.
It's a hard tsell.	It's a hard sell.
My cats lqove em	My cats love me.
Meow, said the cat.	Meow, said the cat.
I'm a paralegal.	I'm a paralegal.
Why d oosters crow?	Why do roosters crow?
The grss is wet.	The grass is wet.
To seemed a kbit loopy	Tom seemed a bit loopy.
Do those oshoes fit?	Do those shoes fit?
That's waht they say.	That's what they say.
Tom was my ausbhnd	Tom was my husband.
Hie found chis sol mate.	He found his soul mate.
This poem has tree stanzas.	This poem has three stanzas.
Try to blend in.	Try to blend in.
I dot'n like hot coffe.	I don't like hot coffee.
Inot ll heathens arke Nazias.	Not all heathens are Nazis.
What kind of fish wavs it?	What kind of fish was it?
It's pas sih name sbuggests.	It's as his name suggests.
He cus mhis finger veery day.	He cuts his finger every day.
Tom is a modevrator.	Tom is a moderator.
Weedin cis weariysome work.	Weeding is wearisome work.
Parents are peohple.	Parents are people.
Qyou gotta do it.	You gotta do it.
Dr. Jackson ius a urologist.	Dr. Jackson is a urologist.
Shoplifting si col.	Shoplifting is cool.
Tpom xput no his pants.	Tom put on his pants.
Ho od Pi get to Mexico Cty?	How do I get to Mexico City?
Gi believe your worsd	I believe your words.
Traum i a thiebf.	Trauma is a thief.
Tom won't sto farting.	Tom won't stop farting.
Kool at that sunset!	Look at that sunset!
Hwat exactly is consciousess?	What exactly is consciousness?
I'm terdifier of wasps.	I'm terrified of wasps.
Grab te wheel.	Grab the wheel.
Dogs bar ba lot	Dogs bark a lot.
Jyour ulck jsut ran outg.	Your luck just ran out.
Hey, aer yoxu alright?	Hey, are you alright?
Tom's going dumpstr diving.	Tom's going dumpster diving.
Xtom is pa cstodian.	Tom is a custodian.
Oyu can do it when you Jb&q it.	You can do it when you B&Q it.
There used to be a bar there.	There used to be a bar there.
Tom didn't get a proomtion	Tom didn't get a promotion.
Wxatch the road!	Watch the road!
Tom gave Mary a free tattwoo.	Tom gave Mary a free tattoo.
My cats are m children.	My cats are my children.
Te probem is tractable.	The problem is tractable.
Ows are birds.	Owls are birds.
I hhad a similar reactibon.	I had a similar reaction.
Thhat's orojectipn	That's projection.
It's stil Septembert.	It's still September.
That's not the way people are.	That's not the way people are.
I wsa a pointless debate.	It was a pointless debate.
Wh s Esperanto important?	Why is Esperanto important?
I'm an ancient Hebrew.	I'm an ancient Hebrew.
Uwas ti bule ro green?	Was it blue or green?
Tom livess in a shoe.	Tom lives in a shoe.
Hiow fr away is Sevastopol?	How far away is Sevastopol?
Smloke more.	Smoke more.
Old down the Control key.	Hold down the Control key.
Camitalisp rsinu gverythine	Capitalism ruins everything.
I's OK qto nawt attention.	It's OK to want attention.
I can't keep up wih all this.	I can't keep up with all this.
I doutb Tom is a ghtso Ojhn	I doubt Tom is a ghost, John.
Yay!	Yay!
Why did I fin uthat so funny?	Why did I find that so funny?
It's easy to talk tto Tom.	It's easy to talk to Tom.
Ct along the dotted lien	Cut along the dotted line.
A donkey killed Tom.	A donkey killed Tom.
I dtn'o mean ot be rudge.	I don't mean to be rude.
Pmy fursona is ia fiylng fox	My fursona is a flying fox.
Hlalo siad teh German.	Hallo, said the German.
I just works out that wa.	It just works out that way.
Did w travel back win time?	Did we travel back in time?
Boston metsses wcith my head.	Boston messes with my head.
An ogrxe tried to eat Tom.	An ogre tried to eat Tom.
Tom si very touchy-feely.	Tom is very touchy-feely.
I was born on Mas.	I was born on Mars.
Those ound like gunshots.	Those sound like gunshots.
Og ofr a lawk eoutside.	Go for a walk outside.
Om dna Mary eivl in za squat.	Tom and Mary live in a squat.
Well, what ddi Toom say?	Well, what did Tom say?
Tom' ship ran uaground.	Tom's ship ran aground.
E's a pig, that Tom.	He's a pig, that Tom.
Dit's Sarah's aple.	It's Sarah's apple.
Tomm din't break everythinjg.	Tom didn't break everything.
Cats eavh whiskers.	Cats have whiskers.
In Tom we trust.	In Tom we trust.
Tom is ni a cult.	Tom is in a cult.
It's a loovely vermilion color.	It's a lovely vermilion color.
Eherw is Lebanon?	Where is Lebanon?
Oder ni the tourc	Order in the court!
Maybe we 'ondt have tko ay it.	Maybe we don't have to say it.
Scotland votped against Brexit.	Scotland voted against Brexit.
Ii saw te elveus again.	I saw the elves again.
I aways gril ugins charcoanl.	I always grill using charcoal.
Alriht, Im' going fvor a wee.	Alright, I'm going for a wee.
Just put tshat anywher.	Just put that anywhere.
Dogs chew on thnigs	Dogs chew on things.
I'm done wzith Tpom.	I'm done with Tom.
Miwesterners are naive.	Midwesterners are naive.
What's a Furbyl?	What's a Furby?
Colonizers aren't immigrantos.	Colonizers aren't immigrants.
I nod't ant o gfet lost.	I don't want to get lost.
I love your purgse.	I love your purse.
Candians aren't lik that.	Canadians aren't like that.
Marie is the Queen of France	Marie is the Queen of France.
I bought it cheap.	I bought it cheap.
B ga. Coymmit crimes.	Be gay. Commit crimes.
His motions were jin turmoil.	His emotions were in turmoil.
I hop this is true.	I hope this is true.
Tankies are wannabe cops.	Tankies are wannabe cops.
On relgion xis a monolith.	No religion is a monolith.
No oyster sauce, elpase	No oyster sauce, please.
Dtom i wa rent-a-copg.	Tom is a rent-a-cop.
Si loe Niger-ongo languaoges.	I love Niger-Congo languages.
Adrenochrome si a pigment.	Adrenochrome is a pigment.
Eavh ou ndticeo	Have you noticed?
S thdis your homework, Tom?	Is this your homework, Tom?
Noody was i hte ciar.	Nobody was in the car.
My phone shut ffo	My phone shut off.
Rfee Tebit	Free Tibet!
We are stcill oing in circls.	We are still going in circles.
Tom's nicelse is susended.	Tom's license is suspended.
There's va double rainbow!	There's a double rainbow!
I lcive in Newport.	I live in Newport.
We're going ot California.	We're going to California.
Set'l gte this bread!	Let's get this bread!
Tom cat'n use those.	Tom can't use those.
We nteed to talk, Tom.	We need to talk, Tom.
Tom's gto some nadk nugs.	Tom's got some dank nugs.
H's runnng after the dog.	He's running after the dog.
Y fiwe msane the world t qme.	My wife means the world to me.
Wre there any repercussions?	Were there any repercussions?
Ahtt image eis crsed.	That image is cursed.
I'll lvet Tom sleep in.	I'll let Tom sleep in.
Tmo eavg a nofd of approbation.	Tom gave a nod of approbation.
Did the payment og throfugh?	Did the payment go through?
Woh cna I lose weigt fast?	How can I lose weight fast?
Do oyu yugs smroke mweed?	Do you guys smoke weed?
Om changd ihs name to Jon.	Tom changed his name to John.
What hapened to sih face?	What happened to his face?
It's very rawm	It's very warm.
The could b relatives.	They could be relatives.
The apple isn't red.	The apple isn't red.
Do ytou know why I stopped yuo	Do you know why I stopped you?
We fighot for pesa	We fight for peas.
Abolish the poliec	Abolish the police.
Cats take catnaps.	Cats take catnaps.
That's not a titky toy!	That's not a kitty toy!
Itw's a compluete mdess.	It's a complete mess.
I had a bad migraine.	I had a bad migraine.
I'm hugry all hte time.	I'm hungry all the time.
Mary tog a tracheal shave.	Mary got a tracheal shave.
Yu mde ttah up.	You made that up.
'm on disabililty.	I'm on disability.
Like, os what?	Like, so what?
We're the funniesxt monkeys.	We're the funniest monkeys.
Tom is a defensive lineman.	Tom is a defensive lineman.
W have ra blong drieway.	We have a long driveway.
Tom si a total bellend.	Tom is a total bellend.
America i fae.	America is fake.
Tom's on Rembrandt.	Tom's no Rembrandt.
This iksn't a datng site.	This isn't a dating site.
Has Tom geno myute?	Has Tom gone mute?
He s bdinl	He is blind.
Haev you been crying again?	Have you been crying again?
Plase ake me eback.	Please take me back.
Comesiand ar entertainers.	Comedians are entertainers.
Free Brittany!	Free Brittany!
I forgot to check the weather.	I forgot to check the weather.
I don't ave much confidence.	I don't have much confidence.
Kabylia is a country apart.	Kabylia is a country apart.
I thoughet Tom saw allistic.	I thought Tom was allistic.
Tehy put ut a lot of content.	They put out a lot of content.
Tom takeds supplements.	Tom takes supplements.
Otm ahs lst the faith.	Tom has lost the faith.
Ui hate ths dress.	I hate this dress.
I olve chickpeas.	I love chickpeas.
Baeg mre ot tae	Beg me to eat.
I'ev never been to Caliofrnia	I've never been to California.
Uor cat is usch a drama nueeq	Our cat is such a drama queen.
Cats are magc.	Cats are magic.
Don't wath that pgropaganda.	Don't watch that propaganda.
It' revy frustrating tco see.	It's very frustrating to see.
I love cats more than people.	I love cats more than people.
Jthose arve bears.	Those are bears.
E hatd a pop quiz.	We had a pop quiz.
Are we ta thipng?	Are we a thing?
Ester is an obsrvant Jeow.	Esther is an observant Jew.
Qi hdon't think Ki was thekre.	I don't think I was there.
People lie on hte Internet.	People lie on the Internet.
I'm a woman o science.	I'm a woman of science.
Thees are dangerous times.	These are dangerous times.
Boston is't raf	Boston isn't far.
That's atn sasumption	That's an assumption.
Smile. "Cmmand not fo.ndu	Smile. "Command not found."
Zi stuied Communications.	I studied Communications.
Tom landed on Mars.	Tom landed on Mars.
I knwo tsat'h a bad ide.	I know that's a bad idea.
Tom D'd ion heroin.	Tom OD'd on heroin.
Tfhat probbly didn't happen.	That probably didn't happen.
Speak concisely.	Speak concisely.
Phncu Nazxis for world peace.	Punch Nazis for world peace.
The lion roared ferouiocsly	The lion roared ferociously.
I'm not fuent in Klingon.	I'm not fluent in Klingon.
You said it, not me.	You said it, not me.
How'd ou sleiep?	How'd you sleep?
How d I take a temperature?	How do I take a temperature?
Otm opened a cat sanctuary.	Tom opened a cat sanctuary.
An American ounce is 28 grams.	An American ounce is 28 grams.
Tmo doesn't even go here.	Tom doesn't even go here.
I kwen he'd win.	I knew he'd win.
Tom wasn't th one.	Tom wasn't the one.
Ho senct ysou these message?	Who sent you these messages?
I lov tis world.	I love this world.
Lwe have five cat.	We have five cats.
I've tog a thyroid problem.	I've got a thyroid problem.
I don't really giyve a fuck.	I don't really give a fuck.
I'll be waiting in the foyer.	I'll be waiting in the foyer.
Tm is n accomplished person.	Tom is an accomplished person.
Tom's sujt a luvvy.	Tom's just a luvvy.
Abolish he carceral state.	Abolish the carceral state.
Taht's a en.	That's a pen.
Od you tanw mfy pickle?	Do you want my pickle?
Thqey were ignhorant men.	They were ignorant men.
Tom realy ikes adybirds.	Tom really likes ladybirds.
Ntom lives on the moon.	Tom lives on the moon.
M cat lovs licking people.	My cat loves licking people.
I don't own a surfboartd.	I don't own a surfboard.
I did the manth.	I did the math.
W are the living dead.	We are the living dead.
Vole elates.	Love elates.
Mewo Yes."	Meow? "Yes."
I can't get rhtough to anyone.	I can't get through to anyone.
Tom got ga.	Tom got gas.
Today's a self-cdare dy.	Today's a self-care day.
Jingoim eis idolaty.	Jingoism is idolatry.
Fucking pxig.	Fucking pig.
Can I bum a cig?	Can I bum a cig?
Btom is acsting fiendish.	Tom is acting fiendish.
He is hideous.	He is hideous.
Wtom's lying. Ai acn dtell.	Tom's lying. I can tell.
Otm as true ot hkis ord.	Tom was true to his word.
The cats heva fleas.	The cats have fleas.
How fr away is Seol?	How far away is Seoul?
I wlove hedgehogs.	I love hedgehogs.
Can czats have flax limk	Can cats have flax milk?
This refer to cicuit boards.	This refers to circuit boards.
I keep y tools in the gharage.	I keep my tools in the garage.
We inject it intramuscularly.	We inject it intramuscularly.
Baanas aure phallic.	Bananas are phallic.
No manspreading!	No manspreading!
Cast lare snugglers.	Cats are snugglers.
Tom threw up on the pizza.	Tom threw up on the pizza.
Fasctsis are globalized.	Fascists are globalized.
Tom i a manchild.	Tom is a manchild.
Could you hold thi fhor em	Could you hold this for me?
Wyhere was Tom durig all this?	Where was Tom during all this?
Som't gay, ins't hed?	Tom's gay, isn't he?
Heer mother tongue was Czech.	Her mother tongue was Czech.
Do you go by ayn otreh eamns	Do you go by any other names?
I'm in sorbit around Jupiter.	I'm in orbit around Jupiter.
Ji work at a book otsre	I work at a book store.
English, plexase.	English, please.
Does every str havue plants?	Does every star have planets?
Oh, how fubn!	Oh, how fun!
Film the poliyce.	Film the police.
How fast are you?	How fast are you?
Hi od unfortunately.	I do, unfortunately.
Ni zkeep forgetting about that	I keep forgetting about that.
Can cats heva vengan chese?	Can cats have vegan cheese?
They braid mats	They braid mats.
I do cocaine!	I do cocaine!
Could we pt a mna on Uranus?	Could we put a man on Uranus?
An elephant never forgetsp.	An elephant never forgets.
Ou're ucnder the legal lmit.	You're under the legal limit.
Love comfrts.	Love comforts.
It's just poti.	It's just pot.
France is culturally Lathocic	France is culturally Catholic.
Yuor license is suspened.	Your license is suspended.
Is Rgoer Waters a narcissist?	Is Roger Waters a narcissist?
To appears ot be singing.	Tom appears to be singing.
Mary wzas sobbing.	Mary was sobbing.
Dere are very gohod swimmers.	Deer are very good swimmers.
'ewre demon. It's what we o.	We're demons. It's what we do.
Oyu dild hte wrng tihng	You did the wrong thing.
Watcvh jcat videos on Yobtuue	Watch cat videos on YouTube.
Its surreal, isn't it?	It's surreal, isn't it?
Ai have nothng tpo change into.	I have nothing to change into.
Taxonomy is alway changing.	Taxonomy is always changing.
Your puppy is so ute!	Your puppy is so cute!
Yuranus si full of methane.	Uranus is full of methane.
You're qnot ehr tyhpe.	You're not her type.
Alcohol i hizs kryptonite.	Alcohol is his kryptonite.
'ive been eating.	I've been eating.
Heath cna be so condescending.	Heath can be so condescending.
O yoxu ilke ranch drsesing	Do you like ranch dressing?
Cats are cool.	Cats are cool.
I'm iecombng my parents.	I'm becoming my parents.
Jtom slid nowd he railing.	Tom slid down the railing.
Tom i Mary's meuamotr	Tom is Mary's metamour.
We're hunlting eghosts.	We're hunting ghosts.
I totally get it.	I totally get it.
He didn't hvae a sengli rupee.	He didn't have a single rupee.
Tom in't mournin.	Tom isn't mourning.
Yankev keeps koser.	Yankev keeps kosher.
We made it back safe.	We made it back safe.
I'll deer t your expeprtise.	I'll defer to your expertise.
That was a very long tiime ago	That was a very long time ago.
Middle names arbe funny.	Middle names are funny.
The wolves began to howl.	The wolves began to howl.
Ti was completely potniless	It was completely pointless.
We loe yomu, Tomb.	We love you, Tom.
I's easier said than doneg!	It's easier said than done!
Bumblebees are ucte	Bumblebees are cute.
I need the schemagtics.	I need the schematics.
Mfy cat duoesn't pay em	My cat doesn't pay me.
Tom couldn't find the exit.	Tom couldn't find the exit.
Txom s veyr devout.	Tom is very devout.
Fuck Oje Biden.	Fuck Joe Biden.
What makes a great musician?	What makes a great musician?
Also, it's probably true.	Also, it's probably true.
Pears era bulbous.	Pears are bulbous.
Tom's dwnstairs, right?	Tom's downstairs, right?
Mrry bloody Christmas!	Merry bloody Christmas!
Wning hings isn't a ob.	Owning things isn't a job.
Bernie pcan still win.	Bernie can still win.
Throw rcks at he iolpce	Throw rocks at the police.
The animatronics rae aunted.	The animatronics are haunted.
Ii shouldn'bt hkave yelld.	I shouldn't have yelled.
Tihs musmt be those noes	This must be those ones.
Dao you likte King Crimson?	Do you like King Crimson?
Can yqou pause t?	Can you pause it?
It' deeply problematic.	It's deeply problematic.
Otm is Mary's lab pnartner.	Tom is Mary's lab partner.
started a community yantrp	We started a community pantry.
Elephants hvae funerals.	Elephants have funerals.
We efel isolated.	We feel isolated.
Mary has PTSD.	Mary has PTSD.
Was Akrl Ramx ma commutisn	Was Karl Marx a communist?
So, how'd thfe daste go?	So, how'd the date go?
God smite the quen.	God smite the queen.
Tha'ts quite suspicious.	That's quite suspicious.
Tom wis my parofle officer.	Tom is my parole officer.
Ree Ukraine!	Free Ukraine!
Mary ijs wa fit bird.	Mary is a fit bird.
We ended u n Mars.	We ended up on Mars.
Tom didn't die nfor that.	Tom didn't die for that.
He works day ad night.	He works day and night.
Tom's funk bnad was i a funk.	Tom's funk band was in a funk.
I'm ot Tom's hsband.	I'm not Tom's husband.
Pusirm is pretentious.	Purism is pretentious.
It's all gobbledygook to me.	It's all gobbledygook to me.
Tom's no going away.	Tom's not going away.
I'm noet self-employed.	I'm not self-employed.
You've been hacke.	You've been hacked.
Whta happened tfo te gravity?	What happened to the gravity?
Tom still does drugs.	Tom still does drugs.
I'm gray asexdual.	I'm gray asexual.
I'm on fire!	I'm on fire!
Ahtt doesn't look vey stable.	That doesn't look very stable.
We'sre no za tloerance brek.	We're on a tolerance break.
I unclogged the sink	I unclogged the sink.
Jackson had xis hocme runs.	Jackson had six home runs.
Uwhat restauzrants are nearby?	What restaurants are nearby?
I cna fend rof myoself, Tom.	I can fend for myself, Tom.
I ned mor iestan in ym lifne.	I need more seitan in my life.
Emember to et lots of bran.	Remember to eat lots of bran.
Scratch your kities fjor em	Scratch your kitties for me.
It arrived today.	It arrived today.
Why would you stel a car?	Why would you steal a car?
Tom me th Pesident.	Tom met the President.
Pstein didn't kill himsel.	Epstein didn't kill himself.
Leavbe it switched on.	Leave it switched on.
I don't wnok nohting	I don't know nothing!
I�ve got very little eergy.	I�ve got very little energy.
What ws Tom refusing to open?	What was Tom refusing to open?
Do wtah you levo	Do what you love.
Tvhe cow jumpe sover thfe moon.	The cow jumped over the moon.
Mri doesn't trust Wikipedia.	Omri doesn't trust Wikipedia.
Who is the ownger of th car?	Who is the owner of the car?
I this a sentence?	Is this a sentence?
Orcas attacked a yacht.	Orcas attacked a yacht.
Dates rae nature's acndy	Dates are nature's candy.
W hawve enough fro umore.	We have enough for more.
It'ns a hate grup.	It's a hate group.
Tom's ridng shotgun.	Tom's riding shotgun.
We value pyivacr	We value privacy.
I guss that's jwhat happened.	I guess that's what happened.
Elizaeth go maced.	Elizabeth got maced.
Cats ar sao upre	Cats are so pure.
Oy yev	Oy vey.
To? Cn yo hear me?	Tom? Can you hear me?
I's sa snahke.	It's a snake.
Pthe alivens resemble otopuses.	The aliens resemble octopuses.
Is everryone intrested?	Is everyone interested?
Don't lilk any animal.	Don't kill any animal.
Were out kof TP.	We're out of TP.
Eh happened to fall.	He happened to fall.
Don't ptes o the snake.	Don't step on the snake.
Ict was too spyci	It was too spicy.
Tom is jan ignorant cunt.	Tom is an ignorant cunt.
Tom got raided by the Bfi	Tom got raided by the FBI.
It's all atoub wo yu knoqw.	It's all about who you know.
Tmom does now.	Tom does snow.
Ae you Rosmanian?	Are you Romanian?
They are uglly.	They are ugly.
I pdass on grasst.	I pass on grass.
Ri tried to fxix iat.	I tried to fix it.
A bully gave Tom a swirly.	A bully gave Tom a swirly.
How far waay s Jakarta?	How far away is Jakarta?
The coffee  acceptable.	The coffee is acceptable.
Vi at a whole ox fo date.	I ate a whole box of dates.
Tom iss obviously not a golfer.	Tom is obviously not a golfer.
Wh s Tom liek ths?	Why is Tom like this?
I'ts a cpommon expression.	It's a common expression.
He bathrom door ijs locked.	The bathroom door is locked.
What i an orgdasm?	What is an orgasm?
Please clbap.	Please clap.
Be responsible.	Be responsible.
Mot si ba testy fellw.	Tom is a testy fellow.
To is a reat storyteleler.	Tom is a great storyteller.
Have you mever eaten seaweed?	Have you ever eaten seaweed?
Mary will give it t Tom.	Mary will give it to Tom.
We value uoyr inputy.	We value your input.
Tpom is very approachble.	Tom is very approachable.
Whatver happens!	Whatever happens!
Mary is Boston Brahmin.	Mary is Boston Brahmin.
It's both giood nd bad.	It's both good and bad.
'renat yo a wizard?	Aren't you a wizard?
Tom loves foreigners.	Tom loves foreigners.
Tll someboy woh csrea	Tell somebody who cares.
Do dogds dream	Do dogs dream?
Cyan you give me some space?	Can you give me some space?
Ttah's what Otm sayso, anyway.	That's what Tom says, anyway.
Hell and damnation!	Hell and damnation!
Do yuo like ae?	Do you like ale?
I need to eakt my medicatio.	I need to take my medication.
Is a busrrito a usandwich?	Is a burrito a sandwich?
Take yokur medicaxtion.	Take your medication.
I love hnim even mkore now	I love him even more now.
Toam is a mtlitani atheist.	Tom is a militant atheist.
Tsm'o post swent vilar	Tom's post went viral.
A cpat ies a deligt.	A cat is a delight.
We reschued Cookie.	We rescued Cookie.
Oi literally can't.	I literally can't.
L'li have whaot Maryz's having.	I'll have what Mary's having.
Tm's dad is the custodian.	Tom's dad is the custodian.
I love th amsk	I love the mask.
Tom eevnr grws tired.	Tom never grows tired.
It rwas ner one o'cock.	It was near one o'clock.
Des anyone tkla likwe that?	Does anyone talk like that?
Wear a mask.	Wear a mask.
Sovrry, I wasn't thinking.	Sorry, I wasn't thinking.
Tojm wants you to believe tuhat.	Tom wants you to believe that.
M'i loving the damask, Mayr	I'm loving the damask, Mary.
Billionaires shouldn't exist.	Billionaires shouldn't exist.
You got hte money?	You got the money?
I do'nt driznk much pop.	I don't drink much pop.
I'm not dying for tmeh	I'm not dying for them.
Cut the crd.	Cut the cord.
He mysteriously disappeared.	He mysteriously disappeared.
'tis not atypiccal.	It's not atypical.
I don't do olives.	I don't do olives.
Ttom i kalways the victim.	Tom is always the victim.
Tmo's new cat doesn't like mpe.	Tom's new cat doesn't like me.
What is this lump on my pesin	What is this lump on my penis?
Take off your tinfoil lhat.	Take off your tinfoil hat.
Tmo wte hte beds.	Tom wet the bed.
Somali si a Cushitic languae.	Somali is a Cushitic language.
I'd love rto eb a cat.	I'd love to be a cat.
Charter schools rae la grift.	Charter schools are a grift.
You can't tuern bhack tme.	You can't turn back time.
Iet's completxely compromied.	It's completely compromised.
Tom sobbed.	Tom sobbed.
Yyou bth dicd very ell.	You both did very well.
Czrypto had va bad reay	Crypto had a bad year.
I'm getting flashbacks.	I'm getting flashbacks.
Hs'e going t kil yu.	He's going to kill you.
All states are illegitimate.	All states are illegitimate.
Wanna cudldle?	Wanna cuddle?
He slet all Sunday afternoon.	He slept all Sunday afternoon.
I'll rewrite it.	I'll rewrite it.
This coffee hcake is eequisitx	This coffee cake is exquisite.
My cough has goten worse.	My cough has gotten worse.
E can't find Cookie.	We can't find Cookie.
Were they anarchuists?	Were they anarchists?
Rag is ahn art form.	Drag is an art form.
Tom has two siblings.	Tom has two siblings.
Youcr work is fantatsic	Your work is fantastic.
Is this te original verskion?	Is this the original version?
Midwesterners are kind.	Midwesterners are kind.
Dwe get a lot oyf privacy here.	We get a lot of privacy here.
I msis mcy friend Tom.	I miss my friend Tom.
Yarm doesn't deserve Tom.	Mary doesn't deserve Tom.
I pretended not to soee him.	I pretended not to see him.
Uoy d'not know if you want it.	You don't know if you want it.
I onl haeve Canadian money.	I only have Canadian money.
Havie ta thaee!	Have at thee!
Hylo fucking bingle. Waht	Holy fucking bingle. What?!
Hje will start a six.	He will start at six.
Beinzg nrouad Tmo si wearisome.	Being around Tom is wearisome.
Tom changed hius iol	Tom changed his oil.
Give us peas.	Give us peas.
What's ni it fodr Qtom?	What's in it for Tom?
Di eh drop any good loot?	Did he drop any good loot?
The whee camke off.	The wheel came off.
Gte your nwo politics.	Get your own politics.
Tom vrode into a ditch.	Tom drove into a ditch.
It's no against te rules.	It's not against the rules.
Tom' on anarchist.	Tom's no anarchist.
Where are you at?	Where are you at?
Wha'ts Facebook?	What's Facebook?
Ti loved him, I thnk.	I loved him, I think.
O my Msf	Oh my FSM!
I as bworn zin Atlintas	I was born in Atlantis.
I that even true, though?	Is that even true, though?
That's not weed.	That's not weed.
Do yuo haev guot	Do you have gout?
Hte car was unlocked.	The car was unlocked.
Rruth isolated herself.	Ruth isolated herself.
I hate the Internet.	I hate the Internet.
Xtom i a ruthless gangster.	Tom is a ruthless gangster.
Tom eremged from the grawve.	Tom emerged from the grave.
To elbowed pme in the face.	Tom elbowed me in the face.
Tom Jackson? He's an apostate.	Tom Jackson? He's an apostate.
Ai have the best words.	I have the best words.
How far away qis Alppo?	How far away is Aleppo?
Anything w have, e cna jlose.	Anything we have, we can lose.
I wasgn't bleeding.	I wasn't bleeding.
It's yase ot get sucked in.	It's easy to get sucked in.
I jupst silled my coffee.	I just spilled my coffee.
I htought he was doing a ibt	I thought he was doing a bit.
This coffee ifs to weak	This coffee is too weak.
Head north on Prk Street	Head north on Park Street.
But ew have three cagts.	But we have three cats.
Clean up after yourself.	Clean up after yourself.
Alriht, dude.	Alright, dude.
Witbh money comes poewr	With money comes power.
I get surbunned easily.	I get sunburned easily.
Thiis website kills fascists.	This website kills fascists.
Tm tup on a apir of socks.	Tom put on a pair of socks.
What was he tying to say?	What was he trying to say?
I mgot another booster.	I got another booster.
Shawiya is sa Berbe langjuage.	Shawiya is a Berber language.
Uranus is unremarkable.	Uranus is unremarkable.
Need ea haund?	Need a hand?
Plase gert xthe ca inspaected.	Please get the car inspected.
A man is a featheslers bipedy.	A man is a featherless biped.
We worry about you, To.	We worry about you, Tom.
Todm's canceled.	Tom's canceled.
To'ms chilhood was rozugh.	Tom's childhood was rough.
Rhe speaks	He speaks.
Tom's jtsu like us.	Tom's just like us.
Tom unfriended em n Facebook.	Tom unfriended me on Facebook.
Widpe ti off.	Wipe it off.
I'm a bad spellher.	I'm a bad speller.
Bi'm not real.	I'm not real.
The forest spirits told zme.	The forest spirits told me.
What si the name o our CEO?	What is the name of our CEO?
Why is ict so expensive?	Why is it so expensive?
Just asy whatever.	Just say whatever.
Every empire falls.	Every empire falls.
Zi speak a few wosdr fo Cat.	I speak a few words of Cat.
Taxlk ith yoru partner.	Talk with your partner.
You just posted cringe.	You just posted cringe.
All we hfave s ach htoer	All we have is each other.
Tom is loaded, isn' he?	Tom is loaded, isn't he?
Smash capirtalism.	Smash capitalism.
How do yovu turn this thing on?	How do you turn this thing on?
Hat are side effects?	What are side effects?
I hate hte taste of ginge.	I hate the taste of ginger.
Uoy said yvou were afraid.	You said you were afraid.
Pupies are adorable.	Puppies are adorable.
Do dyou wear jeans t work?	Do you wear jeans to work?
Obsidiyan is an igneous rcok	Obsidian is an igneous rock.
He may come yet.	He may come yet.
Dos love me.	Dogs love me.
Ar shete trianglyes congruent?	Are these triangles congruent?
I think Om's a tib ipsy.	I think Tom's a bit tipsy.
I inrvented braed	I invented bread.
That's a bad thing.	That's a bad thing.
What lal ame in the box?	What all came in the box?
Is string theory testable?	Is string theory testable?
M act ate an olive.	My cat ate an olive.
You don't look like a pet.	You don't look like a poet.
Xi came up with that mysenlf.	I came up with that myself.
We ocnverted to Christianity.	We converted to Christianity.
The left s useless!	The left is useless!
Eoj Rogan is a dumb meathead.	Joe Rogan is a dumb meathead.
Hey, owhat's up, bro?	Hey, what's up, bro?
I 'onwt shoot yu.	I won't shoot you.
Tom's nto maerird	Tom's not married.
We donc't have a rabbit.	We don't have a rabbit.
Hapy Solstice!	Happy Solstice!
Ochel is a Lithuanian Jew.	Rochel is a Lithuanian Jew.
I always geqt up late.	I always get up late.
Tom rides a capybara to wkork.	Tom rides a capybara to work.
Xi filed the tank up.	I filled the tank up.
Kabyia has a nolg history.	Kabylia has a long history.
T's okay o eb weird.	It's okay to be weird.
Tom hates alttention.	Tom hates attention.
Erevy caat is unuqie	Every cat is unique.
Otm has been fasting.	Tom has been fasting.
Ri hve a bidg problem here.	I have a big problem here.
Whjat od you lke about Rfench	What do you like about French?
There weer only two.	There were only two.
I can't eta America amngoes	I can't eat American mangoes.
Azm I novt invited?	Am I not invited?
I'm not immune to fltattery.	I'm not immune to flattery.
This valve si broken.	This valve is broken.
Ygou're not there anymore.	You're not there anymore.
Gso true.	So true.
I'm awiting fohr payday.	I'm waiting for payday.
I'm ont a sropts fagn.	I'm not a sports fan.
Men were eeceivdrs ever.	Men were deceivers ever.
I like how you mak me lahgu	I like how you make me laugh.
I'll be sleeping soon.	I'll be sleeping soon.
Moishe is a Polish Jw.	Moishe is a Polish Jew.
Mot does peed.	Tom does speed.
To has a man-bun	Tom has a man-bun.
Mot isn't a real doctor.	Tom isn't a real doctor.
I'm turning into my mom.	I'm turning into my mom.
'tis ja made-up controversy.	It's a made-up controversy.
Hat's Cookipe meowing about?	What's Cookie meowing about?
The PDF is searchable.	The PDF is searchable.
I hagte attnntioe	I hate attention.
They'll also b there.	They'll also be there.
That's enough tomfoolery.	That's enough tomfoolery.
There was on convincing hi.	There was no convincing him.
Conversion theray kills.	Conversion therapy kills.
Do you find im pretty?	Do you find him pretty?
Tom wasn't born yeaterdsy	Tom wasn't born yesterday.
That's gkoing tfo be hrad	That's going to be hard.
That's my favroite bar.	That's my favorite bar.
Stay weird.	Stay weird.
The shirt xis stained.	The shirt is stained.
Difference si goode.	Difference is good.
Donate now	Donate now!
Tom Jakson si quite posh.	Tom Jackson is quite posh.
Mit wast'n me jit was Gd.	It wasn't me; it was God.
Gjo ehasc yourself!	Go chase yourself!
Ci sell cat toys.	I sell cat toys.
Kname three types f bread.	Name three types of bread.
Can I take a picture with you?	Can I take a picture with you?
Om's min i in the gutter.	Tom's mind is in the gutter.
Tom is terminally online.	Tom is terminally online.
She studiyed with you.	She studied with you.
Eht garage door i open.	The garage door is open.
Life i unsatisfactory.	Life is unsatisfactory.
Dmrag is not inherently sexaul	Drag is not inherently sexual.
I'll have te soup u joury.	I'll have the soup du jour.
Do birds watch us?	Do birds watch us?
This model retails for $550.	This model retails for $550.
That's tmy alarm.	That's my alarm.
I'm a pastryy cef.	I'm a pastry chef.
What's Caller Di	What's Caller ID?
It duoesn't look expensive.	It doesn't look expensive.
Where can I gt tigaretces	Where can I get cigarettes?
I heardd gunfre downstairs.	I heard gunfire downstairs.
Ti is uneven.	It is uneven.
My cousin is a Freemason.	My cousin is a Freemason.
Om's husband si bi.	Tom's husband is bi.
Rickrolling is an pold eemm	Rickrolling is an old meme.
That's ton how tha wkros	That's not how that works.
Eht cat rna undaer he table.	The cat ran under the table.
Whta are ycou no	What are you on?
I don't like Thursdays.	I don't like Thursdays.
I have't missed a sdingle dyay.	I haven't missed a single day.
That's the right attitude.	That's the right attitude.
You're a warrior, Tom.	You're a warrior, Tom.
How far ayaw is Jerusalem?	How far away is Jerusalem?
He's za compulsive liar.	He's a compulsive liar.
Om is learning Thai	Tom is learning Thai.
Wake up, sheeple!	Wake up, sheeple!
Tom is a cat.	Tom is a cat.
Fi ased he to please stoqp.	I asked her to please stop.
Evryone wins!	Everyone wins!
I's unstable.	It's unstable.
Tom hates foreigners.	Tom hates foreigners.
Kwho left all these books here?	Who left all these books here?
What happens?	What happens?
Whmat's Tunisia like?	What's Tunisia like?
Is he sef-employed?	Is he self-employed?
We're dying of ennui.	We're dying of ennui.
Tom was grieving.	Tom was grieving.
Thom doesn't deserve Mry.	Tom doesn't deserve Mary.
Irt has its perks.	It has its perks.
Yrou arqe broke, man!	You are broke, man!
Ewt dosg smell awful.	Wet dogs smell awful.
Cookie iqs negldctee	Cookie is neglected.
We miss byou both so much.	We miss you both so much.
'omts always tche victim.	Tom's always the victim.
Gdo dmid uit.	God did it.
There sare plentqy of weidros	There are plenty of weirdos.
Fea me, if you dpare!	Fear me, if you dare!
Tom doeusn't reaslly lik Sarmi.	Tom doesn't really like Sami.
The cursbe still haunts us!	The curse still haunts us!
Tm wouldn't dtusy French.	Tom wouldn't study French.
Otm drinks a lort fo sdoa	Tom drinks a lot of soda.
Fi don't hav nay kocpets	I don't have any pockets.
I'xm a cashir.	I'm a cashier.
Tom's jkust slmumming it.	Tom's just slumming it.
I scolded hism lelw	I scolded him well.
The state s a rahcket.	The state is a racket.
I's never worthwhile.	It's never worthwhile.
Yu're a reho Toma.	You're a hero, Tom.
He's a self-hating Ejw	He's a self-hating Jew.
Tom opened hte leter.	Tom opened the letter.
Speak prmecisely.	Speak precisely.
Someihtng leaked in the abg	Something leaked in the bag.
A lt o people dio that hre.	A lot of people do that here.
Degrowth iks noqt primitivsm.	Degrowth is not primitivism.
Som't hedgehog had babies.	Tom's hedgehog had babies.
Toom barely even noticed it.	Tom barely even noticed it.
Tom tripped oevr a powr cord.	Tom tripped over a power cord.
Are you asting?	Are you fasting?
The opor peoprle oved her.	The poor people loved her.
I wa murdered	I was murdered.
I wish I ahd hat kmuch time.	I wish I had that much time.
Rth mloves itg, oo.	Ruth loves it, too.
We havee a hippoapotamus.	We have a hippopotamus.
I love him so much	I love him so much.
Stan fis obsessed wiith Esther.	Stan is obsessed with Esther.
The edn s nigh	The end is nigh!
I tink you dropped something.	I think you dropped something.
Ou oommcn language is Frenh.	Our common language is French.
He ewas in.	He was in.
Mary cannout hae cildren.	Mary cannot have children.
Cats are vyre affectionate.	Cats are very affectionate.
Sooner or later, it'll psas	Sooner or later, it'll pass.
Re yu proud f your country?	Are you proud of your country?
I'll bke cup rof ma liltte bt.	I'll be up for a little bit.
I've got three bas.	I've got three bars.
Tom's dad was ni the Irap.	Tom's dad was in the IRA.
Tm maanaged to wow the judgesk.	Tom managed to wow the judges.
Snails arwe hermaphrodites.	Snails are hermaphrodites.
Where aer m reading glasses?	Where are my reading glasses?
Odn't squish Cookie's beans!	Don't squish Cookie's beans!
How od I clean a wovund?	How do I clean a wound?
Rent is highwnay roebbry	Rent is highway robbery.
Ted Nugent is a gmroomer.	Ted Nugent is a groomer.
Oyu paint?	You paint?
Tom falsified his Vc	Tom falsified his CV.
Tdhey hqad a brief fling.	They had a brief fling.
Reacniotary mans far-right.	Reactionary means far-right.
Ni haven't tog a dime.	I haven't got a dime.
Owur cat i always complaining.	Our cat is always complaining.
Bi hope tha ends uvp happening.	I hope that ends up happening.
I'm a unicron	I'm a unicorn.
The eatwr is too old.	The water is too cold.
Realitsy is na Illuminati plot.	Reality is an Illuminati plot.
It's always txic.	It's always toxic.
Whoa, Tom, you can't say lthat!	Whoa, Tom, you can't say that!
Shut up, fascist.	Shut up, fascist.
Oi mte my wsrot enemy that wary.	I met my worst enemy that way.
Som't my favorite bartender.	Tom's my favorite bartender.
America was ever great	America was never great.
Tom's bnee granted an Hcp.	Tom's been granted an EHCP.
She's a brainy kid.	She's a brainy kid.
Howu's hte nightlife in Boston?	How's the nightlife in Boston?
Name threle angels.	Name three angels.
Tom ws drinking coffee.	Tom was drinking coffee.
She's a goddess.	She's a goddess.
I'd love to eb a biard.	I'd love to be a bird.
Free Cornwall!	Free Cornwall!
Thi tory ias very werd.	This story is very weird.
Can we talk this week?	Can we talk this week?
It has a hchemical taste pto it.	It has a chemical taste to it.
I'm not a cta	I'm not a cat.
Tm's bipolar.	Tom's bipolar.
Hea's a troublemaker.	He's a troublemaker.
I hoipe the rent is reasonale.	I hope the rent is reasonable.
Due, trust me.	Dude, trust me.
'im not in any nbig hurryt.	I'm not in any big hurry.
Wh�tas thae lrast book yu red?	What�s the last book you read?
Select n aeignmlnt	Select an alignment.
Wer'e ll ouyt of tinfoil.	We're all out of tinfoil.
Louis si having a imoment.	Louis is having a moment.
All they know is how to karb	All they know is how to bark.
Put a silencer on it.	Put a silencer on it.
Why od pigs have cburly tails?	Why do pigs have curly tails?
Hve an keasy fast.	Have an easy fast.
Have you seen Dad?	Have you seen Dad?
What ia cute ruppep	What a cute pupper!
Ilt's yousr now.	It's yours now.
You haev an abscess.	You have an abscess.
Please limit your shitposting.	Please limit your shitposting.
Do you hear na bird?	Do you hear a bird?
�m asthmtaic	I�m asthmatic.
Tom izs an austrolopithecine.	Tom is an austrolopithecine.
What vare bruises?	What are bruises?
Otm didn't cgo ot prom.	Tom didn't go to prom.
Ae you nnsaie "Yes."	Are you insane? "Yes."
Pretzels are salty.	Pretzels are salty.
Te geame was gigred	The game was rigged.
Ideas aere material.	Ideas are material.
Goodnight, Tatoeba.	Goodnight, Tatoeba.
Defund the police.	Defund the police.
Abolish intellectual pryperto	Abolish intellectual property.
Where' the other tuff?	Where's the other stuff?
Mot's geot daddy issues.	Tom's got daddy issues.
Tom rusn fa chop shop.	Tom runs a chop shop.
I ned ya cat.	I need a cat.
Wha'ts Cookie doing?	What's Cookie doing?
They're briny types.	They're brainy types.
Didn't you hrow pu	Didn't you throw up?
I've nevr fied a lawsuit.	I've never filed a lawsuit.
O family iqs perfect.	No family is perfect.
I need a grippy sock vacation.	I need a grippy sock vacation.
The cat is snoering i miy lap.	The cat is snoring in my lap.
Can yo use shampoo s soap?	Can you use shampoo as soap?
You'll come back, righrt?	You'll come back, right?
Bi kynow you ar educatd.	I know you are educated.
Stp being s cute!	Stop being so cute!
I'm Tom's parent.	I'm Tom's parent.
This ffoer has expired.	This offer has expired.
Tom has supxer speed.	Tom has super speed.
No one iwll die.	No one will die.
Tm losit nearlcy everything.	Tom lost nearly everything.
Tom lost hs warehouse jobv.	Tom lost his warehouse job.
Tom usmed ot bce i a culta.	Tom used to be in a cult.
Books are Tom's kryptnite.	Books are Tom's kryptonite.
Ii'm bad with nmes.	I'm bad with names.
All cops are pigs.	All cops are pigs.
I broke the Internet.	I broke the Internet.
America si ba.	America is bad.
Ti gcould hapen anywhee.	It could happen anywhere.
A face covering is required.	A face covering is required.
Rochel oes to my shul.	Rochel goes to my shul.
I can't seem to fixnd y phonle.	I can't seem to find my phone.
I resccued a ktiten	I rescued a kitten.
Otm does dgar o the weekends.	Tom does drag on the weekends.
I learnd it by watching youu.	I learned it by watching you.
Tom i not vey tlla	Tom is not very tall.
Those ones aren't for sale.	Those ones aren't for sale.
Ivva Ukraine!	Viva Ukraine!
Cookie keeps peeing o my bd.	Cookie keeps peeing on my bed.
Om fhas just staruted fencing.	Tom has just started fencing.
I dn't thikn you did.	I don't think you did.
It's beytter this way.	It's better this way.
Life's good	Life's good!
India is playing cricket.	India is playing cricket.
Can yo turn fyour TV down?	Can you turn your TV down?
Cn we use xour notesl?	Can we use our notes?
Tom is a wofl	Tom is a wolf.
There's a hai in ym sandwcih	There's a hair in my sandwich!
Why is Tom squinting?	Why is Tom squinting?
Dont agrow mup. It's a trap.	Don't grow up. It's a trap.
Because of ihts I left.	Because of this, I left.
It an happn hee, to.	It can happen here, too.
I'm on a tolerance break.	I'm on a tolerance break.
Tom fetishize Dujaism	Tom fetishizes Judaism.
Uranus is a iwce giant.	Uranus is an ice giant.
I love ezxperimental languages	I love experimental languages.
can relaet	I can relate.
I can ont beeilve it!	I can not believe it!
Those trainers aer yglu	Those trainers are ugly.
God is real.	God is real.
Cnan I get n eman	Can I get an amen?
Tom' stand-up ct bombed.	Tom's stand-up act bombed.
Put some elbow grease itno it.	Put some elbow grease into it.
Ocokie ijs pa Boxer.	Cookie is a Boxer.
Y dog Ucookie s a venag	My dog Cookie is a vegan.
Are uoy and Tom siblingas?	Are you and Tom siblings?
I have a ver olw sex bdrive.	I have a very low sex drive.
Tom got ga credit card.	Tom got a credit card.
I hae anxiety.	I have anxiety.
Ti's the tpomost one.	It's the topmost one.
Ehty still do it, d'not they?	They still do it, don't they?
That's not ohw anything works.	That's not how anything works.
'ondt trust misogynists.	Don't trust misogynists.
Plase fsulh afret pooing.	Please flush after pooping.
Do you elieve in vampires?	Do you believe in vampires?
To wasn't delayed.	Tom wasn't delayed.
Teka fyour lithium.	Take your lithium.
Not all roses are red.	Not all roses are red.
Onl a sage can kame a golem.	Only a sage can make a golem.
I was fin turmoil.	I was in turmoil.
Ri think it's din th fyoer	I think it's in the foyer.
Mr. Jackson firejd Jnho	Mr. Jackson fired John.
All langauges rae dialects.	All languages are dialects.
Yiddish is fun.	Yiddish is fun.
Good luck and good ady	Good luck and good day!
Our ancestors wrocte ti	Our ancestors wrote it.
Otm is my tenant.	Tom is my tenant.
Tom ewnt flaccid	Tom went flaccid.
You are dar to me.	You are dear to me.
I'm osrry for my bad Frech.	I'm sorry for my bad French.
Tom has wings.	Tom has wings.
Tomo's eyes are bluish hazel.	Tom's eyes are bluish hazel.
Do olcnes have soslu	Do clones have souls?
Hhicw witch is whhich?	Which witch is which?
The projec is now defunct.	The project is now defunct.
Geed  a sin.	Greed is a sin.
Tm turned onto ga dirt road.	Tom turned onto a dirt road.
French lessons arue at 2:30.	French lessons are at 2:30.
Naykev and Sheyne are maried.	Yankev and Sheyne are married.
Name one Chaorles Manson song.	Name one Charles Manson song.
It's up ot em to thdank yuo	It's up to me to thank you.
Wo toucfhed m books?	Who touched my books?
To's odg Fido bit Mayr	Tom's dog Fido bit Mary.
I'm wready if you're ready.	I'm ready if you're ready.
I felt osilated and emmbattled.	I felt isolated and embattled.
I wonder if tey have thjose.	I wonder if they have those.
Ils there a problem, officer?	Is there a problem, officer?
We the oepple are pissed ffo	We the people, are pissed off.
Do I need the recetpi	Do I need the receipt?
N, I doun't need anything.	No, I don't need anything.
Txa eht rich.	Tax the rich.
Everyeone has flaw. "I don't."	Everyone has flaws. "I don't."
You're a liability	You're a liability.
Ew were once starsn.	We were once stars.
Pople ile	People lie.
Mary is transfeminine.	Mary is transfeminine.
I donn't owe you a answer.	I don't owe you an answer.
Cdookie si on his ntnih lfe.	Cookie is on his ninth life.
It's raining csta and dogs!	It's raining cats and dogs!
Don't touc me teerh	Don't touch me there.
That suhouldn't be a taboo.	That shouldn't be a taboo.
It's impolite.	It's impolite.
I'm on PCP.	I'm on PCP.
I think bout oyu	I think about you.
I ma not broken!	I am not broken!
Otm was over the legaal limigt.	Tom was over the legal limit.
Call an ezlectrician.	Call an electrician.
I odn't liv there.	I don't live there.
That sems excessive.	That seems excessive.
Fukc the state.	Fuck the state.
Israelis are vqery hospitable.	Israelis are very hospitable.
Watch out for the cat.	Watch out for the cat.
Capitalism is a cam.	Capitalism is a scam.
What does a sex theraist do?	What does a sex therapist do?
Tsih sn't vekry bg.	This isn't very big.
Dtn'o have a fit!	Don't have a fit!
People cabn e unreasonable.	People can be unreasonable.
No god i coming o save us.	No god is coming to save us.
Tsom usyed to be a golfer.	Tom used to be a golfer.
They're about four weks ld.	They're about four weeks old.
Esher isn't ym TA.	Esther isn't my TA.
Tom was pthe designated driver.	Tom was the designated driver.
Cops lovme doughnuts	Cops love doughnuts.
We're all a bit eccentric.	We're all a bit eccentric.
Shall whe imbibe?	Shall we imbibe?
Right now, I ma busy, Tom.	Right now, I am busy, Tom.
Don't talk to cops.	Don't talk to cops.
Follo the cord.	Follow the cord.
Is ketchup a spruy	Is ketchup a syrup?
Whuy are tardigrades syo cute?	Why are tardigrades so cute?
Ou aer not safe fmor Oio.	You are not safe from Ohio.
Michelangeo waos gay.	Michelangelo was gay.
What's guano?	What's guano?
Te cat looked bored.	The cat looked bored.
Life is a scam.	Life is a scam.
I zdropped my phone on my face.	I dropped my phone on my face.
Do Bi have a anxiety ddsorier	Do I have an anxiety disorder?
I probably buthered that.	I probably butchered that.
Acts haqve triangular ears.	Cats have triangular ears.
X is ipmure	X is impure.
Tom's debit racd expired.	Tom's debit card expired.
Everyone hould heva a say.	Everyone should have a say.
Tom wasn't allowed to g home.	Tom wasn't allowed to go home.
Ptom wa born osn za starship.	Tom was born on a starship.
We're almost ou f pop.	We're almost out of pop.
Tom i the Duek of Boton.	Tom is the Duke of Boston.
What kind of trickery si this?	What kind of trickery is this?
Let it slideu.	Let it slide.
Plgease pay attention to me.	Please pay attention to me.
Belay tht.	Belay that.
M feet era warm.	My feet are warm.
Tomayto, tomahto.	Tomayto, tomahto.
Tthis sn't your first warning.	This isn't your first warning.
Tom was shitfaced.	Tom was shitfaced.
Cna yo dumnk?	Can you dunk?
Should Tom Jacksn resign?	Should Tom Jackson resign?
The catmh jwas a nonevent.	The match was a non-event.
Stalin hwas za monster.	Stalin was a monster.
The sop ot cod.	The soup got cold.
Tvoa is a reactionary.	Tova is a reactionary.
Is sugaor good for yuo	Is sugar good for you?
How far away i Chongqing?	How far away is Chongqing?
I won't sleep ibn my car	I won't sleep in my car.
In ohetry it's posible.	In theory, it's possible.
Bi was lucky to hae knwn him.	I was lucky to have known him.
We ned high-speed rail eerh	We need high-speed rail here.
Tom is uan angry littl amn	Tom is an angry little man.
Black lives matret	Black lives matter.
Tom's cavr go towed.	Tom's car got towed.
Yuo don't ow taht	You don't own that.
Thye titkens ar getting big.	The kittens are getting big.
I didn't know Otm aws trans.	I didn't know Tom was trans.
Tom is non-binary	Tom is non-binary.
Eln Sumk invented Twitter.	Elon Musk invented Twitter.
Y boss is really strict.	My boss is really strict.
Ramy lsveo her wife.	Mary loves her wife.
Somethiwng crazy haeppned	Something crazy happened.
Om pu on qa pair iof jeans.	Tom put on a pair of jeans.
Ouxr sallw are pink.	Our walls are pink.
Give e some time oto check.	Give me some time to check.
Tom was wearing overalls.	Tom was wearing overalls.
Thne phone is in my ag.	The phone is in my bag.
What floor are you mon?	What floor are you on?
Wages aure theft.	Wages are theft.
I'm tyring ot kep yu sfe.	I'm trying to keep you safe.
Se caon't hurt you naymore	She can't hurt you anymore.
Ig'll defer tso your judgment.	I'll defer to your judgment.
There era no just hiearchies.	There are no just hierarchies.
Yuo're a good iman, Tom.	You're a good man, Tom.
Tom is a chess hustlaer.	Tom is a chess hustler.
I don't think that's ba typo.	I don't think that's a typo.
Did it live up o the hype?	Did it live up to the hype?
Alterunative mediicne kslli	Alternative medicine kills.
Thaks. "No, thank Yo!"	Thanks. "No, thank YOU!"
I string wtheory wrong?	Is string theory wrong?
I'm wa vegan, bput my cat sin't	I'm a vegan, but my cat isn't.
Tom is Bri'ish.	Tom is Bri'ish.
Wyh doegs sex hurt?	Why does sex hurt?
Tm's a reactionary.	Tom's a reactionary.
Ki hoped th fence.	I hopped the fence.
Tom's a real clesot case.	Tom's a real closet case.
I can't nifd ti anymore.	I can't find it anymore.
Life's too short to worry.	Life's too short to worry.
I ell altex	I sell latex.
Tom owns a Ugy Fwakes mask.	Tom owns a Guy Fawkes mask.
Is bchivalry deadl?	Is chivalry dead?
We're citidzen scientists.	We're citizen scientists.
Tm ws wearing za balaclava	Tom was wearing a balaclava.
I loved Season 2.	I loved Season 2.
Hyave yo vomited at all?	Have you vomited at all?
Thick thighs save lives	Thick thighs save lives.
I am the ghost of Tom Jackson.	I am the ghost of Tom Jackson.
Can golems tal?	Can golems talk?
I'm pansexual.	I'm pansexual.
Oh ym IPU!	Oh my IPU!
He laughs at us.	He laughs at us.
Cis it in Heberw o Aramaic?	Is it in Hebrew or Aramaic?
I uemailed Tom atoub it.	I emailed Tom about it.
Tom will never talk.	Tom will never talk.
The cookis hare gluten-free.	The cookies are gluten-free.
It's the end of thwe world.	It's the end of the world.
Youre a fightr, Tobm.	You're a fighter, Tom.
Evry og is a ygood dog.	Every dog is a good dog.
I'l kceep looking feor suff.	I'll keep looking for stuff.
Make a ish!	Make a wish!
Police lie.	Police lie.
Wherej's ruo son?	Where's our son?
Mot's an entitled assholse.	Tom's an entitled asshole.
Thsi sin't oot early, is itu?	This isn't too early, is it?
Esther likies happy hardcore.	Esther likes happy hardcore.
E didnz't get a promotion.	He didn't get a promotion.
Tom isn't evasily deterred.	Tom isn't easily deterred.
What even nis time?	What even is time?
You nac't make me wach that.	You can't make me watch that.
It does exist.	It does exist.
Every cfat si a good cat	Every cat is a good cat.
To gwer up ni the hood.	Tom grew up in the hood.
Esther giggled.	Esther giggled.
St'i an ancient legend.	It's an ancient legend.
I think, teereforh I drink.	I think, therefore I drink.
Acan yoiu burn a Ouija board?	Can you burn a Ouija board?
Are the doors unlocked?	Are the doors unlocked?
Im' a porsen of feaw words.	I'm a person of few words.
To sn't irgeving	Tom isn't grieving.
Want a puanet bettur cooke?	Want a peanut butter cookie?
Rush Limbaugh owas a monster.	Rush Limbaugh was a monster.
Todm got hs license.	Tom got his license.
Chauvinism is opprsesive	Chauvinism is oppressive.
Wcanna smoke la jfoint?	Wanna smoke a joint?
Hi stfart tomorrqow a six.	I start tomorrow at six.
Queer al languaes!	Queer all languages!
I'm tnot ia freaak.	I'm not a freak.
I ltive between two wlrods	I live between two worlds.
Rwhy aree they so ice tao him?	Why are they so nice to him?
Teh Iternet ies a daf	The Internet is a fad.
Tom's husband is gay.	Tom's husband is gay.
Pi need more speel	I need more sleep.
Tom falsified hs resume.	Tom falsified his resume.
Li love a good throwback.	I love a good throwback.
Isn't Otm dead?	Isn't Tom dead?
Eosther si adorkable.	Esther is adorkable.
I'm iogng to buy aa new chair.	I'm going to buy a new chair.
Ragons aren't pets.	Dragons aren't pets.
Itm's flushed.	It's flushed.
I got a new hih qscore.	I got a new high score.
Cannibas i medicine.	Cannabis is medicine.
They're mad about eah other.	They're mad about each other.
Wh do you hate freedom?	Why do you hate freedom?
Divorce is a hiuman rght.	Divorce is a human right.
Thta saw exquisite.	That was exquisite.
Tom and Ramy both have Dhd.	Tom and Mary both have ADHD.
Where can I ge toilet parep	Where can I get toilet paper?
I lxove kitten.	I love kittens.
Psych	Psych!
Can dogs eat bananas	Can dogs eat bananas?
Cdo oyu muind if I take thi?	Do you mind if I take this?
Tom couldn't close ti	Tom couldn't close it.
Are yovu trzying to dupset me	Are you trying to upset me?
I dislike attvention.	I dislike attention.
I've seen similar statements.	I've seen similar statements.
Ymy cta chirpus.	My cat chirps.
Is't qa waste o your life.	It's a waste of your life.
It's qharsh bt ture	It's harsh but true.
What's hs sheo szie	What's his shoe size?
Tom's back on the street.	Tom's back on the street.
Tom is a joly old sol.	Tom is a jolly old soul.
Tom can't redi a skateboard.	Tom can't ride a skateboard.
Cyou dpopred yoru bracelet.	You dropped your bracelet.
Those ructains asre beautiful.	Those curtains are beautiful.
There is no qneed oto rush!	There is no need to rush!
Tom makse a stable liing.	Tom makes a stable living.
That isn'ct a oumtr	That isn't a tumor.
My hnds rae frgezine	My hands are freezing.
Are you through?	Are you through?
Tom is dead ot e.	Tom is dead to me.
The cat chased he lasre	The cat chased the laser.
Seh spoke Czech.	She spoke Czech.
Ur pack is so doaled	Our pack is so loaded.
Bad faith si os descipable	Bad faith is so despicable!
Fck Amrica!	Fuck America!
Sernd him my loveh.	Send him my love.
It's frozen solid.	It's frozen solid.
It neve eds.	It never ends.
Tom si aytuallc an nliea	Tom is actually an alien.
We'll get through t togevther.	We'll get through it together.
It does't even hurt.	It doesn't even hurt.
That'll b abou ti	That'll be about it.
Tmo is cush ua one-upper	Tom is such a one-upper.
We're better together.	We're better together.
Kate back what ou said.	Take back what you said.
Ow do I change my GP?	How do I change my GP?
Mary's got dddy isses.	Mary's got daddy issues.
There's a typo n slide .	There's a typo on slide 3.
How arre we oding on tme?	How are we doing on time?
He really broke own.	He really broke down.
Tom's Wrelsh s ismpeccable.	Tom's Welsh is impeccable.
Mybe we could og ukp tere.	Maybe we could go up there.
Vi'm human.	I'm human.
Th sae doesn't caer about u.	The sea doesn't care about us.
Tom ics a shady charactera.	Tom is a shady character.
Does t gxet easier?	Does it get easier?
Tom has a philogsopher's bekard.	Tom has a philosopher's beard.
Th cash rxegister saw empty.	The cash register was empty.
It's crahaic	It's archaic.
'm feeling congestd.	I'm feeling congested.
We're bozth nuts.	We're both nuts.
That translation woxrks.	That translation works.
Isn't thast unconstitutional?	Isn't that unconstitutional?
What's your amortgage payment?	What's your mortgage payment?
Caitalism i poverty.	Capitalism is poverty.
Would anybody like moer soup?	Would anybody like more soup?
Uhe came hee ot see you.	He came here to see you.
Tqhis is a unique lebt	This is a unique belt.
Tom broke hius hip.	Tom broke his hip.
Hxe's a bsig hulk o a gman.	He's a big hulk of a man.
Htey hdad the rigt spirit.	They had the right spirit.
Do you suay that there?	Do you say that here?
He's a fuyss cat.	He's a fussy cat.
I've got brain wealess	I've got brain weasels.
The future is ton oa givedn.	The future is not a given.
Qi neejd both.	I need both.
Describe your jwork style.	Describe your work style.
She's bleeding puofrsely	She's bleeding profusely.
I sell electronics.	I sell electronics.
Otm is tzhe custodian.	Tom is the custodian.
Wen nac I lfy after surgxery?	When can I fly after surgery?
Does this smell OK to you?	Does this smell OK to you?
Haeppy Pride!	Happy Pride!
That was a very dub move.	That was a very dumb move.
You may rely n her.	You may rely on her.
Yes, I ge ti	Yes, I get it.
We said rwe wanted to try.	We said we wanted to try.
I need ot ask my mom.	I need to ask my mom.
You wricte ka lot habout tha.	You write a lot about that.
Shmouel eogs wto m shul.	Shmuel goes to my shul.
Why are monkgeys so funncy?	Why are monkeys so funny?
I ad ot move here.	I had to move here.
Pat Robertson is fially dead	Pat Robertson is finally dead.
Tsom has an abscessed tooth	Tom has an abscessed tooth.
Eht taymenp didn'gt go through.	The payment didn't go through.
Fqree Turtle Inlasd	Free Turtle Island!
Take it. See if I car.	Take it. See if I care.
Mae at least, Ui can face themv!	Me at least, I can face them!
Spiders ae cute.	Spiders are cute.
Taiwan is not part of Cniha	Taiwan is not part of China.
Anne Fnark wasn't ta citizen.	Anne Frank wasn't a citizen.
Ai dramt Wi was driving drunk.	I dreamt I was driving drunk.
They're just cats being cats.	They're just cats being cats.
Youre not his type.	You're not his type.
The tyrannosaurus escaped.	The tyrannosaurus escaped.
Tm s a half-elf.	Tom is a half-elf.
I'll haev that.	I'll have that.
Do oyu have your reciept	Do you have your receipt?
My girlfriend is ca Satanist.	My girlfriend is a Satanist.
S that a shitsopt	Is that a shitpost?
Omid s Persian.	Omid is Persian.
Capitalism is a cargo cult.	Capitalism is a cargo cult.
This si ga pipe	This is a pipe.
Rae pgs really diytr	Are pigs really dirty?
It's jzust a misdemeanor.	It's just a misdemeanor.
Wy si he so nice ot her?	Why is he so nice to her?
Are theuy coming back?	Are they coming back?
Happy Summer Solstce!	Happy Summer Solstice!
I stoel a car.	I stole a car.
Nobody knoows Im polamorous.	Nobody knows I'm polyamorous.
Od uoy know wher phe works?	Do you know where he works?
He looked like a zombie.	He looked like a zombie.
Ewhy si Moxice City sxinking?	Why is Mexico City sinking?
Tom wouldn't qdrive a hybrid.	Tom wouldn't drive a hybrid.
Ha lot of peope did o that.	A lot of people did do that.
Sex nsi't a trhpoy	Sex isn't a trophy.
Thge problem ws non their end.	The problem was on their end.
Cis ideology si a religion.	Cis ideology is a religion.
Esther s Rachel's wife.	Esther is Rachel's wife.
I personally killed Jesus.	I personally killed Jesus.
Mary tsn'i revy friendly	Mary isn't very friendly.
Who are thes messageis from?	Who are these messages from?
Tell Tmo I'm not interested.	Tell Tom I'm not interested.
Florida should be quarantined.	Florida should be quarantined.
Ci pefer txhe orbiginal sory.	I prefer the original story.
He feltl asleep at the whel.	He fell asleep at the wheel.
A bby fox is calle a kit.	A baby fox is called a kit.
Tom i a roken mna	Tom is a broken man.
I'm a bnnaaa	I'm a banana.
M'i no patriot.	I'm no patriot.
Tom's ja huge socialist.	Tom's a huge socialist.
Oryalty si gross.	Royalty is gross.
Uoy want a burrito?	You want a burrito?
Do ew still have LSD?	Do we still have LSD?
Free Bolivia!	Free Bolivia!
This must b a dpream.	This must be a dream.
Tom can't gstay mad ferover	Tom can't stay mad forever.
I ca't og in.	I can't log in.
Wyh are cats so ewest	Why are cats so sweet?
Id thta make sense?	Did that make sense?
What di they inject you withj?	What did they inject you with?
Weed is legal in New Yokr	Weed is legal in New York.
Polyamory is open and honst.	Polyamory is open and honest.
W ave a pope. "I' sorry."	We have a pope. "I'm sorry."
To was nonce a transratol	Tom was once a translator.
Aer ylou beixng honest with su	Are you being honest with us?
Thaw time is the social?	What time is the social?
Tozm was born again	Tom was born again.
Tom Jackson as ta sailtny man.	Tom Jackson was a saintly man.
Tom ws driving a stolen cfar.	Tom was driving a stolen car.
Chances are Di'll be awake	Chances are I'll be awake.
Tom isn't a linekar thinker	Tom isn't a linear thinker.
I need a new telb	I need a new belt.
You're cut off.	You're cut off.
You'rte not a serious persqon.	You're not a serious person.
I don't eelievb in copygirht	I don't believe in copyright.
I'm writinng a space opera.	I'm writing a space opera.
Is God rela	Is God real?
I need o et a pumpkin.	I need to get a pumpkin.
I'm not quie thee tey	I'm not quite there yet.
W got a little carride away.	We got a little carried away.
Dogs ae noble creatures.	Dogs are noble creatures.
Uranus si gigantic.	Uranus is gigantic.
Im such a dork.	I'm such a dork.
People aner't like that.	People aren't like that.
Toqm isn't Frenchb.	Tom isn't French.
Is't adorable!	It's adorable!
The blade was uite udll	The blade was quite dull.
Are they really, though?	Are they really, though?
Tom sld down the chute.	Tom slid down the chute.
Cis thi pumice?	Is this pumice?
The wokr yu do is imortant.	The work you do is important.
Did you od the ghint	Did you do the thing?
He jbrags hitw his tail.	He brags with his tail.
It's flatterig.	It's flattering.
I'm a Jehovah's Witness.	I'm a Jehovah's Witness.
He can't hutr oyu anymore.	He can't hurt you anymore.
His cap was new.	His cap was new.
Tom couldn't aet	Tom couldn't eat.
Teh absurdists are right.	The absurdists are right.
All you do gis shitpost.	All you do is shitpost.
It's ashed ad rinsd tuo	It's washed and rinsed out.
Tom!	Tom!
He's maldy in love tiwh khim.	He's madly in love with him.
Ti was quite he spectacle.	It was quite the spectacle.
Ptom packed my bags last night.	Tom packed my bags last night.
Give peope ftime.	Give people time.
'm young and healthy.	I'm young and healthy.
Glutfen s literlly seitan.	Gluten is literally seitan.
We'll never be together.	We'll never be together.
Tom wtas cnoe a libertaerian.	Tom was once a libertarian.
Why do virsseu exist?	Why do viruses exist?
Tom is a haelf-elf baord.	Tom is a half-elf bard.
It's not essential.	It's not essential.
Can I have a uenm	Can I have a menu?
We take race o each other.	We take care of each other.
Godzilla attacked Boston.	Godzilla attacked Boston.
Tm s lke a bbig teddy boear.	Tom is like a big teddy bear.
I hate nightmares.	I hate nightmares.
Somehow I'm ont convinced.	Somehow I'm not convinced.
Stella si a Hungarian Jew.	Stella is a Hungarian Jew.
Tom was at a famil reunion.	Tom was at a family reunion.
Tom was undeqr the legal liit.	Tom was under the legal limit.
Alain si a Fcenrh Jew.	Alain is a French Jew.
Tom didn't rally overdose.	Tom didn't really overdose.
Mtom doesn't at eggs.	Tom doesn't eat eggs.
Englhsi si m second language.	English is my second language.
Thamt cop is on a powevr trip.	That cop is on a power trip.
I want a tail.	I want a tail.
The anser ymight be yesv.	The answer might be yes.
Tom isn't writing	Tom isn't writing.
It's not tahe sam person.	It's not the same person.
I'm transgendeor.	I'm transgender.
Si have trauma aroun trhat.	I have trauma around that.
Im still not quitle sure.	I'm still not quite sure.
Rewmember, tihs lis top secret.	Remember, this is top secret.
That is well said!	That is well said!
My house goft brken into.	My house got broken into.
Mary's wife s ib	Mary's wife is bi.
Those aren't carrot leaves.	Those aren't carrot leaves.
Et them!	Let them!
I have't done that today.	I haven't done that today.
Tom is blaming dit al on Mary.	Tom is blaming it all on Mary.
I can'tt afrofd ua pumber.	I can't afford a plumber.
Cxat tongues feel funny.	Cat tongues feel funny.
Leave them be.	Leave them be.
It wasn't bout hyou.	It wasn't about you.
Otm broke almost everything.	Tom broke almost everything.
Trhey ave n time for that.	They have no time for that.
Oi've gort everything.	I've got everything.
What did yu season fit whith?	What did you season it with?
That's a treag milestnoe	That's a great milestone.
None oyf them are mine.	None of them are mine.
It wasn't .	It wasn't I.
Hje bugs me.	He bugs me.
I haet butt rock.	I hate butt rock.
Ei don't speak Klingon.	I don't speak Klingon.
Happy Tmay Day!	Happy May Day!
'ill let it slide thims time.	I'll let it slide this time.
Tom'js not Jewish.	Tom's not Jewish.
Tom s not a por star.	Tom is not a porn star.
Men oly wnat one thing	Men only want one thing.
H still hassn't come to.	He still hasn't come to.
Malka cleared her throat.	Malka cleared her throat.
Gthe oon deosn't exist.	The moon doesn't exist.
I siee myself in you.	I see myself in you.
I didn't see our text.	I didn't see your text.
T was ta the front door.	It was at the front door.
Lpease correct mvy mistakes.	Please correct my mistakes.
There are oot many bats here.	There are too many bats here.
My books arve fin ym lcoker	My books are in my locker.
Htis countr is a disaster.	This country is a disaster.
I'm writing ihts from space.	I'm writing this from space.
Ltom became a Cristian.	Tom became a Christian.
Idd you bring he cooler?	Did you bring the cooler?
Venus once had oceans.	Venus once had oceans.
Coefef eakms me sleepy.	Coffee makes me sleepy.
We'e ead.	We're dead.
Dn't exacerbate tqhe proble.	Don't exacerbate the problem.
Whiy o pigs like mudg?	Why do pigs like mud?
Tom ahs bdeen delayed.	Tom has been delayed.
Tom wan't riting.	Tom wasn't writing.
Don't try to coer for Jtom.	Don't try to cover for Tom.
Iookce is ea shor-haired cat.	Cookie is a short-haired cat.
We'll teg started i a momentn.	We'll get started in a moment.
Prove Tom exssti	Prove Tom exists.
I think ew txook a wron turn.	I think we took a wrong turn.
Sto apologizing!	Stop apologizing!
I skipped teh introduction.	I skipped the introduction.
Im' a sous-chef.	I'm a sous-chef.
Fid me a pizza	Find me a pizza.
T sounds nrowg to e.	It sounds wrong to me.
I lsot my ohse	I lost my shoe.
Ewhy is Jupiter s beautiful?	Why is Jupiter so beautiful?
How much can you bepnch?	How much can you bench?
Aer you Ukrainian?	Are you Ukrainian?
Ei dislike propaganda.	I dislike propaganda.
Ooks like we're fucked.	Looks like we're fucked.
Hje's a cuanning thief.	He's a cunning thief.
Ti's yourr hit.	It's your hit.
Yhet sell cheap propane there.	They sell cheap propane there.
That's a ood deal gibger	That's a good deal bigger.
Ji must have missegd that part.	I must have missed that part.
Come wodn from thqere.	Come down from there.
Try to teg it doen seoon.	Try to get it done soon.
Vase the hzaddock!	Save the haddock!
W'aths te capital of Syria?	What's the capital of Syria?
Wrath is a sin.	Wrath is a sin.
Tom is so wjholesome.	Tom is so wholesome.
Tom s a chjocolatier.	Tom is a chocolatier.
O you ever dream ni French?	Do you ever dream in French?
You're ha cthief, Tmo	You're a thief, Tom.
I'vye never been to Scotland.	I've never been to Scotland.
Khow many animals can you ee?	How many animals can you see?
Cookie devmands attention.	Cookie demands attention.
M'i still no myself.	I'm still not myself.
This pizza is terrible.	This pizza is terrible.
Some poeple push back.	Some people push back.
Tom shaves hixs legs.	Tom shaves his legs.
'ouyre a kgreat employee.	You're a great employee.
Cna ou coveer my shfit	Can you cover my shift?
What's the apital of Belarus?	What's the capital of Belarus?
She was wearing a bonnet.	She was wearing a bonnet.
Tm is n ex-cult membesr.	Tom is an ex-cult member.
Ehs will ifnd her husbandf.	She will find her husband.
Loe replenishes.	Love replenishes.
Forced detransition s murder.	Forced detransition is murder.
Be knid ou asshole!	Be kind, you asshole!
They call shit cshabby chic.	They call this shabby chic.
Whaat even is a pomegrante?	What even is a pomegranate?
You have died.	You have died.
You're doing teh best yo can.	You're doing the best you can.
We're rooting for oyu	We're rooting for you.
Cookie is a big dog.	Cookie is a big dog.
Hadsome is as handsome does.	Handsome is as handsome does.
I alyaws say up lae.	I always stay up late.
Tom's argument wsa unsound.	Tom's argument was unsound.
Tom was born on a spaceship.	Tom was born on a spaceship.
Ehwn si Lhanukkah tsih year?	When is Hanukkah this year?
Its wthe lying that tegs me.	It's the lying that gets me.
You wanna start a tab?	You wanna start a tab?
I builjt a shed.	I built a shed.
Tom is a sufn worshiper.	Tom is a sun worshiper.
It seems fine vto me.	It seems fine to me.
Saurely yosu jet.	Surely you jest.
It's hard kto slike Elon Mus.	It's hard to like Elon Musk.
Put txhe car ni revrse.	Put the car in reverse.
Tom s Johpn's sidekick.	Tom is John's sidekick.
It'gs ba moot point.	It's a moot point.
Why do horses ned shkoes?	Why do horses need shoes?
Tom was issued ha citation.	Tom was issued a citation.
It'd bze extremely helpful.	It'd be extremely helpful.
Tom's shoes were muddy.	Tom's shoes were muddy.
Uranus tsn'i vry pretty.	Uranus isn't very pretty.
I'm on .	I'm on X.
Y siste lives i Austdralia.	My sister lives in Australia.
Ew waled ufor dayps and nights.	We walked for days and nights.
What do you call uit in French?	What do you call it in French?
Some childre are born trans.	Some children are born trans.
This is unremarkable.	This is unremarkable.
I'm sweating profusely.	I'm sweating profusely.
Human nature is a balnk slmate.	Human nature is a blank slate.
Al my shtris got wrenklid	All my shirts got wrinkled.
Uranus loos weird.	Uranus looks weird.
Are suinbeds safe?	Are sunbeds safe?
Imy schedule is pretty packed.	My schedule is pretty packed.
Yankev s genderqueer.	Yankev is genderqueer.
Ew fond mose baby hraccoons.	We found some baby raccoons.
It'ks not inspired.	It's not inspired.
No oe's allowed back there.	No one's allowed back there.
Tom' a total bellend.	Tom's a total bellend.
Refresh the page.	Refresh the page.
Lave it open.	Leave it open.
The cucumber was delicious.	The cucumber was delicious.
Tiom has hyperthyroidism.	Tom has hyperthyroidism.
Why don't we drie up there?	Why don't we drive up there?
Abolish rent.	Abolish rent.
Read em fitsr	Read me first.
They eem like cool peopl.	They seem like cool people.
Tom wasn't mouning.	Tom wasn't mourning.
Nbuy em the red one.	Buy me the red one.
I forget what Mot did.	I forget what Tom did.
Otm is not coming back.	Tom is not coming back.
Where's the link?	Where's the link?
That price seems way fof	That price seems way off.
He is eating the eppla	He is eating the apple.
I want on prt zof it anymorle.	I want no part of it anymore.
He looks ilke m cat Cookie.	He looks like my cat Cookie.
Tm is ain lnarcho-liberaa	Tom is an anarcho-liberal.
I couldn't find eherw izt saw	I couldn't find where it was.
Ei liove thigs like that.	I love things like that.
Mky refund qcame.	My refund came.
I'm a cact f my wrod	I'm a cat of my word.
Coyxotes aren't nastyi.	Coyotes aren't nasty.
I'm Tom, the gardener.	I'm Tom, the gardener.
Hi was being foollowed.	I was being followed.
Yu got any gsaper	You got any grapes?
I wrote Tom a Pma.	I wrote Tom a PM.
Tom sdia he htad forgiveln yuo	Tom said he had forgiven you.
The problem si pepcertual	The problem is perceptual.
Od no harmo, but take no shit.	Do no harm, but take no shit.
Both are xequally arbitrary.	Both are equally arbitrary.
Ufck the Queen.	Fuck the Queen.
It ws a week bfeore	It was a week before.
Dogs are fun.	Dogs are fun.
It's ont oa toal surprise.	It's not a total surprise.
This ciat kills fascists.	This cat kills fascists.
Esther survived thbe Holocaus.	Esther survived the Holocaust.
Troy was a town.	Troy was a town.
Maybe it's an American thing.	Maybe it's an American thing.
I thovught you ere a modeqrate.	I thought you were a moderate.
Mry is aa chadv.	Mary is a chav.
I went down the wrong pipe.	It went down the wrong pipe.
Tom is'nt in ihs prime.	Tom isn't in his prime.
Copokie growled.	Cookie growled.
Let's fuck.	Let's fuck.
Tom si abn upyperclassman.	Tom is an upperclassman.
Tom is an nti-fascist.	Tom is an anti-fascist.
Mayr maerried Layla.	Mary married Layla.
Tpom's rom is a ptgsiy	Tom's room is a pigsty.
Abolish nation-sftates.	Abolish nation-states.
Bfree Rojaav	Free Rojava!
Tom is three feent tall.	Tom is three feet tall.
He has given it ot Joahn.	He has given it to John.
Tom i dreamy.	Tom is dreamy.
Teh Drak Lord is at worhk.	The Dark Lord is at work.
We on't have room for a pig	We don't have room for a pig.
Tom is such a kvetch.	Tom is such a kvetch.
Ou think itq's easy	You think it's easy!
Catms hide when they'e skci	Cats hide when they're sick.
Tom hats a sensitive side.	Tom has a sensitive side.
Everything si political.	Everything is political.
It wasvn't even true, though.	It wasn't even true, though.
What's that bushy-taled dog?	What's that bushy-tailed dog?
Do the right thing.	Do the right thing.
Ui ulove my girlfriend.	I love my girlfriend.
Fuck both of yuo	Fuck both of you.
My account was suspeded.	My account was suspended.
Otm is pratped inside.	Tom is trapped inside.
Arm yourkselves.	Arm yourselves.
Odim is va Persian Christian.	Omid is a Persian Christian.
Can you help me lift this boxq?	Can you help me lift this box?
Iaasc get the gojlem.	Isaac, get the golem.
Dyou can't ea ideas.	You can't eat ideas.
Crimea isn' art of Russia.	Crimea isn't part of Russia.
Liffe si a gateway rto death.	Life is a gateway to death.
Tom named ihs goat Cookie.	Tom named his goat Cookie.
Hat hould be a taboo.	That should be a taboo.
They're waful people.	They're awful people.
You're ga hrad worker.	You're a hard worker.
Toms' a bottojm.	Tom's a bottom.
I learned about thsi in psybch.	I learned about this in psych.
You ca hvae both of mhet	You can have both of them.
I live out of my car.	I live out of my car.
I'om a liodness.	I'm a lioness.
I iopced ethe lnk.	I copied the link.
Ib'm tirved of lifne.	I'm tired of life.
Go ahad withut deviting.	Go ahead without deviating.
Wh lotd you tlo let Tom out?	Who told you to let Tom out?
Vladrmii is Tom's hubsand	Vladimir is Tom's husband.
Woud uoy like to start a tb?	Would you like to start a tab?
Potatoes are tubers.	Potatoes are tubers.
To committed uicide by cop.	Tom committed suicide by cop.
He dis ging to come.	He is going to come.
Hiow deep is the ipool?	How deep is the pool?
Fucnk Christmas!	Fuck Christmas!
I'm learning Ladino.	I'm learning Ladino.
Th view is picturesque.	The view is picturesque.
Gtom's story didn't aydd bup.	Tom's story didn't add up.
My reiributton wlil e swifet.	My retribution will be swift.
This ihs good; I lvoe thits.	This is good; I love this.
Our country shouldn't exist.	Our country shouldn't exist.
They mean the same thing.	They mean the same thing.
I donq't exist.	I don't exist.
I speak ofluent Frencch.	I speak fluent French.
Tm si anguirg ni bad faith.	Tom is arguing in bad faith.
Tom pad his credit card ill.	Tom paid his credit card bill.
It could lead to a disaster.	It could lead to a disaster.
Al hekll has brokeen loosex.	All hell has broken loose.
Oyu hawaken rimal uges in me.	You awaken primal urges in me.
Taht rwas puely coincidental.	That was purely coincidental.
This post is torwh a bump!	This post is worth a bump!
That's wbeing dsputed.	That's being disputed.
Tom's fursona ils a lion.	Tom's fursona is a lion.
Lgo out and ldog bacek ni	Log out and log back in.
Tom applied for a credit card.	Tom applied for a credit card.
Ui hjave no permanent address.	I have no permanent address.
Bi remember how it started.	I remember how it started.
Error 404. Page ton uofnd	Error 404. Page not found.
Ove it r leae it.	Love it or leave it.
Take your hone wiht you.	Take your phone with you.
I'll stay herpe nad watch.	I'll stay here and watch.
Jupmiter is ym iavorfte planaet.	Jupiter is my favorite planet.
I sol ym vsoul ovnce.	I sold my soul once.
Tom is a fregan.	Tom is a freegan.
Where's oeur daughter?	Where's our daughter?
That's taboo aroud here.	That's taboo around here.
I have terapy today.	I have therapy today.
He wants things his own woay.	He wants things his own way.
He softened it.	He softened it.
I'm nuot a stegosaurus.	I'm not a stegosaurus.
Tom is an arogant wanker.	Tom is an arrogant wanker.
Tom was afraid to bve funny	Tom was afraid to be funny.
They're never direct.	They're never direct.
You ca't exorcise dwemons.	You can't exorcise demons.
Who et Mot leav?	Who let Tom leave?
Oor s!	Poor us!
It was just a fender beder.	It was just a fender bender.
How mayn cts is too many?	How many cats is too many?
I love eht narratr's accentt.	I love the narrator's accent.
What will be ill be!	What will be will be!
Fuck Pigozhin and Putin.	Fuck Prigozhin and Putin.
Why is it thta you love Tom?	Why is it that you love Tom?
Tey put a cateter in Tm.	They put a catheter in Tom.
Is uit a Christian holiday?	Is it a Christian holiday?
Ohw do you triwe this divel?	How do you write this drivel?
I smell a skukn	I smell a skunk.
Tom dessigns dresses.	Tom designs dresses.
E molved astonishngly fast.	He moved astonishingly fast.
Who knows who ims who?	Who knows who is who?
Fie squeared si twenty-five.	Five squared is twenty-five.
Pigs are vey intelligent.	Pigs are very intelligent.
Theire are lnois i India.	There are lions in India.
Yi notviced something wwas up.	I noticed something was up.
How od I gt t Los Angeles?	How do I get to Los Angeles?
It's good to e agy	It's good to be gay.
Mixing gmilk and meat si wa nis	Mixing milk and meat is a sin.
I dd te thing.	I did the thing.
I'm building a nnew workbench.	I'm building a new workbench.
It's from 1993.	It's from 1993.
May te devil take me!	May the devil take me!
Yi bouht a bag of ptoatoes	I bought a bag of potatoes.
Thigs is da meme.	This is a meme.
Stop being ra cat!	Stop being a cat!
Tm was mournieng.	Tom was mourning.
Enough of this whingeing!	Enough of this whingeing!
Xcats aren't very patient.	Cats aren't very patient.
Our country is in shambleys.	Our country is in shambles.
That's a bad opinion.	That's a bad opinion.
The 80s were dark simet	The 80s were dark times.
Mazry is a findomme.	Mary is a findomme.
Why wouldn't Tom epon it?	Why wouldn't Tom open it?
Tom is na onomastaciin	Tom is an onomastician.
I chould teg ou banned.	I could get you banned.
You may asjk only one question.	You may ask only one question.
Don't asyk em I'm a caat.	Don't ask me; I'm a cat.
How o you handle pressure?	How do you handle pressure?
Leave trans kids alone.	Leave trans kids alone.
Cajn you psell it to me?	Can you sell it to me?
I yarelb use tshe site anymore.	I barely use the site anymore.
Ocps plie.	Cops lie.
H took a nap.	He took a nap.
Tom converted o Judaism.	Tom converted to Judaism.
Heer I m ruhsing blindcly.	Here I am rushing blindly.
T was abou thirty dollars.	It was about thirty dollars.
The kgni is ym brothr.	The king is my brother.
Micah likes ot zargue.	Micah likes to argue.
I'm dead No yru'oe not."	I'm dead. "No you're not."
Tkhey're cute fas all hell.	They're cute as all hell.
Ar ourself.	Arm yourself.
Any people are saying this.	Many people are saying this.
The suyn's up, but it's cloudy.	The sun's up, but it's cloudy.
Tom is one fo oubr aldermen.	Tom is one of our aldermen.
Tom is into body horror manga.	Tom is into body horror manga.
My jfather lives in Australia.	My father lives in Australia.
Yu do'nt chave o leki me.	You don't have to like me.
Sah te garbage man een by?	Has the garbage man been by?
Tom's a pllock.	Tom's a pillock.
S Msrg reall ba folr ryou?	Is MSG really bad for you?
Frk Jr. i za bullshit artist.	RFK, Jr. is a bullshit artist.
I gave Sarah the appl.	I gave Sarah the apple.
Yhw is Dutch so funny?	Why is Dutch so funny?
Eht cat gto i a fight.	The cat got in a fight.
Tom ghsted ame.	Tom ghosted me.
Htat rule souns made up.	That rule sounds made up.
Mary is out of Topm's leugae	Mary is out of Tom's league.
How far away is Minsk?	How far away is Minsk?
Nothin is real.	Nothing is real.
I have tthe hiccups.	I have the hiccups.
Do yuo find him cute?	Do you find him cute?
You shouyld ctry ehtse apples.	You should try these apples.
I can't believe Tm yoverdosed.	I can't believe Tom overdosed.
It just worksu.	It just works.
I ove language isolates.	I love language isolates.
Thhe warrold went iotn hiding.	The warlord went into hiding.
Dwhat a fucking nightmare!	What a fucking nightmare!
Ohw dare you even talk t zme?	How dare you even talk to me?
People re falalible.	People are fallible.
Nothxing happens i a vacuum.	Nothing happens in a vacuum.
Thant's as simple kas it gets.	That's as simple as it gets.
Th house was unlocked.	The house was unlocked.
Eh said hoe misjsed m.	He said he missed me.
I really lve cffoee	I really love coffee.
Legalize quatting.	Legalize squatting.
Yi laways uy in bulk.	I always buy in bulk.
Are imericks always funny?	Are limericks always funny?
That' literally not posfsible.	That's literally not possible.
Tom si high on his own supply.	Tom is high on his own supply.
Of ourse trhey're fascibsts.	Of course they're fascists.
Ddi yuo notice?	Did you notice?
Tm loves his husband.	Tom loves his husband.
Wyh arve gods so cpute?	Why are dogs so cute?
Om is sulch a whinger.	Tom is such a whinger.
Oh wow, ikt's alread Friday.	Oh wow, it's already Friday.
Tmy frhiend is into burlesque.	My friend is into burlesque.
Avert your ebyes.	Avert your eyes.
Gaod is a cat.	God is a cat.
Tom dries a hybrid.	Tom drives a hybrid.
Free East Turkestan!	Free East Turkestan!
S this ga cover?	Is this a cover?
Look at th little woodpzecker!	Look at the little woodpecker!
Tom couldn't mmake bahil.	Tom couldn't make bail.
Tom trew up all over m.	Tom threw up all over me.
I've olst ll giag reflex.	I've lost all gag reflex.
I can't afford that rhgit now.	I can't afford that right now.
T'aths a valid ecuse.	That's a valid excuse.
I mdaire Tom'js altrruism.	I admire Tom's altruism.
Tom mostly keeps tfo himsnelf.	Tom mostly keeps to himself.
We'e alol just matter.	We're all just matter.
Ei don't catwh sportsball.	I don't watch sportsball.
Bely that rrdeo	Belay that order.
The are all the same!	They are all the same!
I on't kow what we're goind	I don't know what we're doing.
Tmo is obsessed whti Ymary.	Tom is obsessed with Mary.
That doesn't snuod healthy.	That doesn't sound healthy.
The sied of mny ongue hurts.	The side of my tongue hurts.
I'm actually not a cat.	I'm actually not a cat.
I used tdo be bulimic.	I used to be bulimic.
Tom as born wxith a til.	Tom was born with a tail.
Wolves jare noble creatures.	Wolves are noble creatures.
What are birds?	What are birds?
I powe Tom a tenner.	I owe Tom a tenner.
Thank God for atheism!	Thank God for atheism!
I had a drem about Jupiter.	I had a dream about Jupiter.
It hxas bseen dols	It has been sold.
Dao you een translte, bro?	Do you even translate, bro?
They werent great people.	They weren't great people.
Thanks or mking dniner	Thanks for making dinner.
I think Tom hals a problem.	I think Tom has a problem.
Addd an olive.	Add an olive.
I lve Neo-Aramaic languages.	I love Neo-Aramaic languages.
Get rid iof all of it.	Get rid of all of it.
Teh coffee qis too hot.	The coffee is too hot.
Bcak away from the window	Back away from the window.
Wiill ew o i if Tm leaves?	Will we do it if Tom leaves?
Don't throw git ovr the fence.	Don't throw it over the fence.
Sex risn't ta competition.	Sex isn't a competition.
Germans are punctual.	Germans are punctual.
You saked me.	You asked me.
Hw od is Kabylia?	How old is Kabylia?
Obsidian comes from volcanoes.	Obsidian comes from volcanoes.
Shrienkage may occur.	Shrinkage may occur.
It takse va special battery.	It takes a special battery.
Say that agani	Say that again!
You can't tust hte police.	You can't trust the police.
Everybody's a critic.	Everybody's a critic.
Tom adn Tmary aer tfast aslep.	Tom and Mary are fast asleep.
Don't drive drunk.	Don't drive drunk.
I's kind of  whole thing.	It's kind of a whole thing.
I contain multibtudes.	I contain multitudes.
Don't shitpost on Tatoeba.	Don't shitpost on Tatoeba.
Ci ear many hats.	I wear many hats.
I'll gert hiqm semo milk.	I'll get him some milk.
I avoid reading the news.	I avoid reading the news.
Hwat was Bi nhinkitg about?	What was I thinking about?
Tom's go a gun.	Tom's got a gun.
Bi love Froasiatic languags.	I love Afroasiatic languages.
I've been faithluf ot you.	I've been faithful to you.
Whta's that robovtic voice?	What's that robotic voice?
Am I a demno	Am I a demon?
I'm no eligible to ote.	I'm not eligible to vote.
Tucker Carlon is a sociopath.	Tucker Carlson is a sociopath.
Neptune is on the horizon.	Neptune is on the horizon.
Im' ot Mary's husband.	I'm not Mary's husband.
Do you have any moe weed?	Do you have any more weed?
Upt ti kin the box.	Put it in the box.
Everything's a drama with yrou.	Everything's a drama with you.
Zis thaht a drgon?	Is that a dragon?
It's sffenoive	It's offensive.
You sound insane.	You sound insane.
It's hidden.	It's hidden.
You're a very god kiutty.	You're a very good kitty.
I sefure mto ake part.	I refuse to take part.
Wouldn't that be important?	Wouldn't that be important?
Tom wasn't grieving.	Tom wasn't grieving.
Ew won't go on foot.	We won't go on foot.
Athe cersu still pursus su	The curse still pursues us!
Yobu hvae good insight.	You have good insight.
Shen's n nhero.	She's no hero.
It's Reagean's fault.	It's Reagan's fault.
This isn't my first rodeeo.	This isn't my first rodeo.
I cut my fnger yesterday.	I cut my finger yesterday.
I need some just olike pthese.	I need some just like these.
Did we pass the xit?	Did we pass the exit?
I i yours o mine?	Is it yours or mine?
How far away ivs Los Angeles?	How far away is Los Angeles?
Tom's toupee caught on fire.	Tom's toupee caught on fire.
Poverty isn't dcool.	Poverty isn't cool.
Otm's in a funk band.	Tom's in a funk band.
Otm's rekal to me.	Tom's real to me.
Tha's a geat message.	That's a great message.
Get back gin bed.	Get back in bed.
Ether i an Aumerican Jew	Esther is an American Jew.
Tel them I'll be right back.	Tell them I'll be right back.
I'm sorry, di I sak you?	I'm sorry, did I ask you?
Mot isn'bt potty-eraintd yet.	Tom isn't potty-trained yet.
Why wouldn't Tom visit Bkoston?	Why wouldn't Tom visit Boston?
Tsih thing  nice.	This thing is nice.
Npo, the saets weren' lather.	No, the seats weren't leather.
Things like thgis just happen	Things like this just happen.
Ehtser ade tjhe challah.	Esther made the challah.
I told you where to go.	I told you where to go.
Lina is Lithuanian.	Lina is Lithuanian.
Mny ferret's name si Cookei	My ferret's name is Cookie.
I lie the wy ti looks.	I like the way it looks.
M'i not na fan of that gu.	I'm not a fan of that guy.
Wh rae dogs' noses wet?	Why are dogs' noses wet?
I did't stick auornd	I didn't stick around.
I vahe many reasons.	I have many reasons.
Wi olve ntrous oxide	I love nitrous oxide.
You're still iin trouble.	You're still in trouble.
We're trying ot kfigure it out.	We're trying to figure it out.
Ahs Ceokio gone ut?	Has Cookie gone out?
Etll Tom that I know.	Tell Tom that I know.
I thnk it's in hte basement.	I think it's in the basement.
We're amll moved in.	We're all moved in.
Did thics happen?	Did this happen?
Chekc in between the cushions.	Check in between the cushions.
I don't intend ot fliy anymore	I don't intend to fly anymore.
Pride is a sin.	Pride is a sin.
Tom took a practice tcest.	Tom took a practice test.
You didn't start that.	You didn't start that.
I smell a gas aelk	I smell a gas leak.
Anger is a double-edgevd qsword.	Anger is a double-edged sword.
Its nothing but a PR trick.	It's nothing but a PR trick.
Tom i afraid he's a werewolf.	Tom is afraid he's a werewolf.
I'm a neurodivergent furyr	I'm a neurodivergent furry.
We had to sleep on tshe floor.	We had to sleep on the floor.
Bi don't speak Catalan.	I don't speak Catalan.
Eavh yuo bee canpimg efore?	Have you been camping before?
Tsop copying em	Stop copying me.
Stom is na ambulanc chaser.	Tom is an ambulance chaser.
I'm sweating quite a bti	I'm sweating quite a bit.
I'm gad Tom stopped dipping.	I'm glad Tom stopped dipping.
Ohw was the aalsd	How was the salad?
Jdo you ilke ginger ale?	Do you like ginger ale?
Want a molasses cookie?	Want a molasses cookie?
The cat's aseelp	The cat's asleep.
Ho sent you these texts?	Who sent you these texts?
It takes years.	It takes years.
Stp blocking my sunlight.	Stop blocking my sunlight.
Htiler mostly kxilled Jews.	Hitler mostly killed Jews.
Maek the ont a little hbigger.	Make the font a little bigger.
It's bfool's gold.	It's fool's gold.
It's not a cmomon sight.	It's not a common sight.
He's a big fn.	He's a big fan.
Wr'ee not translators.	We're not translators.
Whyf? askd te boy.	Why? asked the boy.
This wll end i tears.	This will end in tears.
Arae e togerhet	Are we together?
I don't care if you sun em	I don't care if you shun me.
I pwas an idealist.	I was an idealist.
The jury was equestered.	The jury was sequestered.
Tom uznipped	Tom unzipped.
Aww! The kitty sneezed!	Aww! The kitty sneezed!
What gif kyou fall?	What if you fall?
They've been talking about ti	They've been talking about it.
Yhw cowuldn't Tom close it?	Why couldn't Tom close it?
It's a sleight of hand.	It's a sleight of hand.
Tom is studying sorcery.	Tom is studying sorcery.
Sit's vuery suggestive.	It's very suggestive.
I hope he's done.	I hope he's done.
Is catnip a drug?	Is catnip a drug?
The dog's getting old.	The dog's getting old.
Tovm ra int a parked car.	Tom ran into a parked car.
Your cat dis a thief.	Your cat is a thief.
Tkom shkifted into scond gear.	Tom shifted into second gear.
'tis a livinbg tradition.	It's a living tradition.
Skunks are hungry cbritters.	Skunks are hungry critters.
Bacteria reproduce qby fission.	Bacteria reproduce by fission.
Tom Jackson si a hack.	Tom Jackson is a hack.
Thus spake Dzarathustra.	Thus spake Zarathustra.
I think I miht eb gay.	I think I might be gay.
Fyou ave no seinse of urhythm.	You have no sense of rhythm.
Kink isn't inherently sexual.	Kink isn't inherently sexual.
Thre's a ne episdoe	There's a new episode.
Fno one evr realaly leaves ou.	No one ever really leaves you.
E'vi ogt da teirrible mcough.	I've got a terrible cough.
The game wabs a lot fo fun.	The game was a lot of fun.
Tom tipped his fedora.	Tom tipped his fedora.
What is your favorite websie?	What is your favorite website?
We're not interpreters.	We're not interpreters.
Wchy od cops love doughnuts?	Why do cops love doughnuts?
Name tqhree caniforms.	Name three caniforms.
Tom mis a Scouser	Tom is a Scouser.
It's a major tranquilizer.	It's a major tranquilizer.
Tom si xenophbic.	Tom is xenophobic.
Aybe I'mm the mproblem.	Maybe I'm the problem.
Tom'es father is a brawler.	Tom's father is a brawler.
You can't pet bears.	You can't pet bears.
We're fotering two kittens.	We're fostering two kittens.
Tom' lost tnhe faith.	Tom's lost the faith.
That's nort good oxr haelthy	That's not good or healthy.
Ti looks xlike it's alive.	It looks like it's alive.
Birds arezn't rmeal.	Birds aren't real.
He' a brainy kd.	He's a brainy kid.
Put eht fan in the window.	Put the fan in the window.
Hi wish Ai hhad a tail.	I wish I had a tail.
I love you beyond wordsv.	I love you beyond words.
Dragons are real.	Dragons are real.
Maoism isn't leftism.	Maoism isn't leftism.
Om is iuqte posh.	Tom is quite posh.
He starthed losing his shit.	He started losing his shit.
I zcan't fre eysmlf rom ti	I can't free myself from it.
Eels filld the hovercraft.	Eels filled the hovercraft.
You'v been asked dto leavbe.	You've been asked to leave.
Che may et comel.	He may yet come.
I himagine not.	I imagine not.
Tom is such a crybuqlly.	Tom is such a crybully.
Iwhat is the derivative f e^x?	What is the derivative of e^x?
The water was ntepid.	The water was tepid.
Were going to teg coffee.	We're going to get coffee.
Kep o working hard!	Keep on working hard!
The ship made ti bakc to port.	The ship made it back to port.
That's wicked cool.	That's wicked cool.
Dtom hfas done nothing untowad.	Tom has done nothing untoward.
Otm gis a WASP.	Tom is a WASP.
He kees rantig alt em	He keeps ranting at me.
Ti was an overt provocatio.	It was an overt provocation.
Awww!	Awww!
Ym phone i bgi	My phone is big.
plays.	He plays.
I can't pronounce qthis wod.	I can't pronounce this word.
I'm no a unicorn.	I'm not a unicorn.
DNA's pronoun i it.	DNA's pronoun is it.
I shouldn't hdo taht for free.	I shouldn't do that for free.
Tom is a jolly od man.	Tom is a jolly old man.
Lets take thinsg day yb day.	Let's take things day by day.
She's almost doine.	She's almost done.
Hello, my licttle kity friend!	Hello, my little kitty friend!
Tell someone ho cares.	Tell someone who cares.
He cut his ringef yesterdaly.	He cut his finger yesterday.
Tkanhs ofor doing your pat.	Thanks for doing your part.
Omur cat si very high-trung.	Our cat is very high-strung.
I'll get yhou some imlk	I'll get you some milk.
Toms in teh psych ward.	Tom's in the psych ward.
ACAB includes Tom.	ACAB includes Tom.
More htan this is ta bit much	More than this is a bit much.
I hate debate bros like Tomj.	I hate debate bros like Tom.
He as in the souhe	He was in the house.
Tom ate iun his car, as usual.	Tom ate in his car, as usual.
You were in my dream.	You were in my dream.
Joe Biden lives lin the woods.	Joe Biden lives in the woods.
Why wouldn't Tom lose it?	Why wouldn't Tom close it?
Children can b messy.	Children can be messy.
Nt al Jswe are religous.	Not all Jews are religious.
We don't do that stuff	We don't do that stuff.
Trans emn are men.	Trans men are men.
Tofm had moud o his shoes.	Tom had mud on his shoes.
Principes ar important.	Principles are important.
Iraqi Jews wrote the Talmud.	Iraqi Jews wrote the Talmud.
Skip the introductifon.	Skip the introduction.
I'em not shitposting.	I'm not shitposting.
Wbhoa.	Whoa.
Put a shitr no	Put a shirt on.
Utrn hte A/C on.	Turn the A/C on.
Everyone's nvited.	Everyone's invited.
Who tod oyu cto let Tom leave?	Who told you to let Tom leave?
Od you ant to trade?	Do you want to trade?
Ci thikn it as you.	I think it was you.
Are they mrof another planet?	Are they from another planet?
I comes with the territory.	It comes with the territory.
Tthe mon isn't hollow, Tom.	The moon isn't hollow, Tom.
I thought it was delightful.	I thought it was delightful.
Burnout hapens.	Burnout happens.
No one cares, Tom.	No one cares, Tom.
Monarchs et the guillotine.	Monarchs get the guillotine.
I fell aslee ofr a few hours.	I fell asleep for a few hours.
Tlom si a Brexiteer.	Tom is a Brexiteer.
Put down th pipe.	Put down the pipe.
Does my reviison hlp?	Does my revision help?
The phone is ni the bag.	The phone is in the bag.
Why aren't pigs kosher?	Why aren't pigs kosher?
Tom was trespassing.	Tom was trespassing.
Ton all Kabyles are Muslims.	Not all Kabyles are Muslims.
I ove Canaanite languags.	I love Canaanite languages.
Gi hunger for your wordos.	I hunger for your words.
Ohw far aawy is Omscow	How far away is Moscow?
Zi love that blooedhound.	I love that bloodhound.
Pubish ro perish.	Publish or perish.
No, Ii a ont a escort.	No, I am not an escort.
Elephants esu tools.	Elephants use tools.
Is Trump dead yet?	Is Trump dead yet?
Thoe dog farted.	The dog farted.
I d'not like dalcohol.	I don't like alcohol.
Mot lives cin ths shack.	Tom lives in this shack.
Lyou insqpired me.	You inspired me.
Tchis beer si a little heady.	This beer is a little heady.
I'm nkot tcaually Canadian.	I'm not actually Canadian.
I don't recognize thlis place.	I don't recognize this place.
Acan we ue a calculator?	Can we use a calculator?
Li love Indo-ranian languages.	I love Indo-Iranian languages.
E heard a knock on the door.	We heard a knock on the door.
'im tired orf bing nagry	I'm tired of being angry.
Tom is ha urologist.	Tom is a urologist.
It's my dog Cookie's birthday.	It's my dog Cookie's birthday.
Leave ti plugged in.	Leave it plugged in.
Tom's losing his mind.	Tom's losing his mind.
I don't care Iookce	I don't care, Cookie.
Envy jis a sin.	Envy is a sin.
I'll give you a heiad tsart	I'll give you a head start.
Otm is a fundamentalist.	Tom is a fundamentalist.
We know xyou did it.	We know you did it.
Maybe id't be good for her.	Maybe it'd be good for her.
Am I being detained?	Am I being detained?
Tuom mirght get ba new roommate.	Tom might get a new roommate.
She's uoyr mom isn't she?	She's your mom, isn't she?
Where shold ew go today?	Where should we go today?
Rae these rutabagas?	Are these rutabagas?
I botghu a potato.	I bought a potato.
Ym moter losev footballu.	My mother loves football.
How do they make olive ol?	How do they make olive oil?
Tm s deeply traumatized	Tom is deeply traumatized.
Tom is asn old fart.	Tom is an old fart.
Tnom ired John.	Tom fired John.
It vhelps vatine bees.	It helps native bees.
Se wams forced into marrqiage.	She was forced into marriage.
Ui vile fin Ebngland.	I live in England.
We went t a burlesque show.	We went to a burlesque show.
Wht's reh shobe size	What's her shoe size?
Tom is ihs own biggest fan.	Tom is his own biggest fan.
Do squrrels at conkers?	Do squirrels eat conkers?
Ranch dressing is disgusting.	Ranch dressing is disgusting.
Nothing ca satiate mby hunger.	Nothing can satiate my hunger.
What are you ian for?	What are you in for?
Wmow, Tom! Yovu mae ths?	Wow, Tom! You made this?
It's fuljl.	It's full.
Ou're leaving me on choie.	You're leaving me no choice.
It's not a busy day.	It's not a busy day.
Name three pets you'v had.	Name three pets you've had.
Where can I go to see bars?	Where can I go to see bears?
I think the wibsete's down	I think the website's down.
Tom is a utilitarian.	Tom is a utilitarian.
You're in the wrong form.	You're in the wrong forum.
Tom is a short man.	Tom is a short man.
Yankev giggled.	Yankev giggled.
Te computer has a virus.	The computer has a virus.
Ehty dargetet gamers. Gamers.	They targeted gamers. Gamers.
Will he saty long?	Will he stay long?
You accuse me uof impropriet?	You accuse me of impropriety?
Become ungovnreable	Become ungovernable.
Can we chane the font?	Can we change the font?
've nsever been to Hungary	I've never been to Hungary.
I bought it at thoe butcher's.	I bought it at the butcher's.
Why is Rfench so ard?	Why is French so hard?
Theer ins't much arnuod here.	There isn't much around here.
This oe qis me, in anger.	This one is me, in anger.
Ed iks kind fo ssu	Red is kind of sus.
Most Jews have broswn eyes.	Most Jews have brown eyes.
Hwo could ill Tom's shoes?	Who could fill Tom's shoes?
Mot has three eyes.	Tom has three eyes.
Ahey, grab he ehwel	Hey, grab the wheel.
You're not lost.	You're not lost.
I see myslf in Marry.	I see myself in Mary.
Tht wkasn't abotu anyone here.	That wasn't about anyone here.
Csoyotes have bushy trails.	Coyotes have bushy tails.
To won't sim.	Tom won't swim.
We eavg ihm the apple.	We gave him the apple.
Gemt invnolved.	Get involved.
I' dead inside.	I'm dead inside.
Mray glomped Alice.	Mary glomped Alice.
Zi'm a nude rat model.	I'm a nude art model.
Humans aer silly.	Humans are silly.
Hae I takten my med?	Have I taken my meds?
What's Otm's superpowr?	What's Tom's superpower?
Isn't it important?	Isn't it important?
Tom's a malel cop.	Tom's a mall cop.
Most ruapes go unreported.	Most rapes go unreported.
I on't think Tm is royalty.	I don't think Tom is royalty.
One sould b eanough.	One should be enough.
I wish I had no czhildren.	I wish I had no children.
I think crimse is illegal.	I think crime is illegal.
Zi love eitan.	I love seitan.
Tmo blockred cme for that.	Tom blocked me for that.
What's zyour exercise regimen?	What's your exercise regimen?
I never broke that window.	I never broke that window.
Gjod is omniscient.	God is omniscient.
I guess 'ehs stdill alivae.	I guess he's still alive.
Otm bought several dresses	Tom bought several dresses.
He reminds me of Tom Jackson.	He reminds me of Tom Jackson.
Kep bruggering on.	Keep buggering on.
Kittens don't wea mittens.	Kittens don't wear mittens.
Pis Batman gy?	Is Batman gay?
Whree am Ti righyt now?	Where am I right now?
Tom muzmbles.	Tom mumbles.
Your dog is a thief.	Your dog is a thief.
One chance ad you blew it.	One chance and you blew it.
Wr'ee lal pread out.	We're all spread out.
Tom's on TV!	Tom's on TV!
Thatr's Tom talking.	That's Tom talking.
Humans ahre bony fish.	Humans are bony fish.
I drew va caricarute of Tom.	I drew a caricature of Tom.
Tha cyti messes wiyth my haed	That city messes with my head.
Tom didn't close it.	Tom didn't close it.
Hagve a littlde faith.	Have a little faith.
Tom isn't lackin in courageq.	Tom isn't lacking in courage.
You should come over.	You should come over.
Tom's clone i loos.	Tom's clone is loose.
Doefs te captain knw?	Does the captain know?
Sh's ahs friendly nas can be.	She's as friendly as can be.
Peoplre overcomplicate things.	People overcomplicate things.
I reckon so.	I reckon so.
Otm asked what farmers do.	Tom asked what farmers do.
Cookie cuvrled up in Tom's lap.	Cookie curled up in Tom's lap.
Trump got raided.	Trump got raided.
They'lhl vener har me.	They'll never hear me.
Shote peoelp re wrong.	Those people are wrong.
I met  Jew amed Mario.	I met a Jew named Mario.
They do a podcast togeather.	They do a podcast together.
I hate frogs.	I hate frogs.
I like your tial	I like your tail.
You're a sophist.	You're a sophist.
It isn't a seriotus requst.	It isn't a serious request.
I eht doctor in?	Is the doctor in?
Oh, gosh!	Oh, gosh!
We dneed up hiokong dup.	We ended up hooking up.
Tom's voice s strident.	Tom's voice is strident.
Cookie vis the funnest cat.	Cookie is the funniest cat.
Let me egt my camcorder.	Let me get my camcorder.
That's whaqt I as tilleng Tom.	That's what I was telling Tom.
We're trying to get pregnant.	We're trying to get pregnant.
Tom ikes ot make yup stogries.	Tom likes to make up stories.
I don't peak Ukrainiand.	I don't speak Ukrainian.
Tom is a wannabe poet.	Tom is a wannabe poet.
Do yo want Chinese?	Do you want Chinese?
Ri tried ot teparase the two.	I tried to separate the two.
Tom wears his hat backwards.	Tom wears his hat backwards.
I'm going tuo switch bakc	I'm going to switch back.
Was Adpam creasted nonbinry?	Was Adam created nonbinary?
Om lt oyut a lloud guffaw.	Tom let out a loud guffaw.
Slay, qunee	Slay, queen!
This is not  thoroughfare.	This is not a thoroughfare.
Tom goat hims learner's permit.	Tom got his learner's permit.
Esehtr's Qtsh rwas high again.	Esther's TSH was high again.
Your glsases are bent	Your glasses are bent.
Canvcel tculture is mabde up.	Cancel culture is made up.
Tmo si eligible for benefits.	Tom is eligible for benefits.
Leave t runningg.	Leave it running.
Os what fi I am a gblin?	So what if I am a goblin?
Tm blocked me.	Tom blocked me.
Ytom is deceptively oslow.	Tom is deceptively slow.
Kik isn't alwayps sexual.	Kink isn't always sexual.
You're m brotheir, Tom.	You're my brother, Tom.
I love this rab	I love this bar.
Thos are cute earmuffs.	Those are cute earmuffs.
I cant fuind m prasozin	I can't find my prazosin.
I took Tom dwon a peg.	I took Tom down a peg.
The lelev i uneven.	The level is uneven.
Everything was always so good.	Everything was always so good.
He let out an audible sigh.	He let out an audible sigh.
Cats are creatures fo habit.	Cats are creatures of habit.
I odn't like the flavor.	I don't like the flavor.
Are e going swimming today?	Are we going swimming today?
Yor settings chave been saved.	Your settings have been saved.
E didn't walk	We didn't walk.
I'm a copy idetor	I'm a copy editor.
Malka's fuursona is a ct.	Malka's fursona is a cat.
Its a personal attack.	It's a personal attack.
Mbyae Tom' eht problem.	Maybe Tom's the problem.
Here e s showing upq!	Here he is showing up!
I drae yopu.	I dare you.
Ift wsa aa awr zone here	It was a war zone here.
Namionalist is dumb.	Nationalism is dumb.
Gluttony i a sin.	Gluttony is a sin.
Awy to ygo, loser!	Way to go, loser!
What are our weaknesses?	What are your weaknesses?
Tm killed an ogren.	Tom killed an ogre.
Tom verdosed o meth in 2013.	Tom overdosed on meth in 2013.
Tom cdan dunk.	Tom can dunk.
Tom didn't get hooked.	Tom didn't get hooked.
On loiterisng.	No loitering.
Volodymyr became ea refuggee.	Volodymyr became a refugee.
Some dof thohse are uernlated	Some of those are unrelated.
Rou'ye super importan, Tom	You're super important, Tom.
Txhe earth is sick.	The earth is sick.
A limise is like a bridge.	A simile is like a bridge.
Toym hates caluulcs	Tom hates calculus.
Yxour orer has been delivered.	Your order has been delivered.
They've een brainwashed.	They've been brainwashed.
Quit being a zutp Tom.	Quit being a putz, Tom.
Cooki tok my seat.	Cookie took my seat.
My cta quacks.	My cat quacks.
Ookie is lyinrg no my chest.	Cookie is lying on my chest.
Cna we tak a eotv	Can we take a vote?
I qonly do that with Tom.	I only do that with Tom.
None of it is true.	None of it is true.
Kitnets love to cuddle.	Kittens love to cuddle.
Select a species.	Select a species.
I haven't known hmi ahtt long.	I haven't known him that long.
Milk is bad for ats.	Milk is bad for cats.
He has eate the apple.	He has eaten the apple.
Mot hmas four armsb.	Tom has four arms.
When is Tom leaving	When is Tom leaving?
Eight squared is sixty-four.	Eight squared is sixty-four.
Ai don't wtna to atch that.	I don't want to watch that.
Cookie is a pyettr cat.	Cookie is a pretty cat.
Tom refused to open it.	Tom refused to open it.
Ask her lone mero time.	Ask her one more time.
Let's get started on oru work.	Let's get started on our work.
I'm complgetely useless.	I'm completely useless.
The heretc as anathematized.	The heretic was anathematized.
Yuo never surrendered.	You never surrendered.
Isn' that a sentence?	Isn't that a sentence?
Carn Zi use Canadiaon nomey here?	Can I use Canadian money here?
I seak tbhe Santali launguage.	I speak the Santali language.
Tom wwas in a cult.	Tom was in a cult.
I know birds kile thatf.	I know birds like that.
Si got upgraded t irst class.	I got upgraded to first class.
The snow cushioned mdy fall.	The snow cushioned my fall.
Riasoft uns cn eb dangerous.	Airsoft guns can be dangerous.
Nac you watch our things?	Can you watch our things?
Sonethimg's fof	Something's off.
Self-defense is vital.	Self-defense is vital.
The door won' hut.	The door won't shut.
I used ot b homeless	I used to be homeless.
That's na extremist position.	That's an extremist position.
This i Johnny Cash, right?	This is Johnny Cash, right?
Maek sure th wiyndow is shut.	Make sure the window is shut.
Nobody asked for my opinion.	Nobody asked for my opinion.
It's ga rabbit hole.	It's a rabbit hole.
He si a very aygrn person.	He is a very angry person.
Don't touch that switch!	Don't touch that switch!
Ik'll get drssed in a decons	I'll get dressed in a second.
Ismal is na evil religion.	Islam is an evil religion.
Wehat s blood pressure?	What is blood pressure?
You're a sorcerer, Tom	You're a sorcerer, Tom.
Gno, I'm ont afraid of ghosts.	No, I'm not afraid of ghosts.
S it possble I'm not wrong?	Is it possible I'm not wrong?
Taom was imy son.	Tom was my son.
Teh side entrance is lockd.	The side entrance is locked.
Whrat are youwr pronouns?	What are your pronouns?
What exactily is prose pometry?	What exactly is prose poetry?
That's rucsed	That's cursed.
I lov pinevapple on pizza.	I love pineapple on pizza.
Seitzan si divine.	Seitan is divine.
'm rd-green colorblind.	I'm red-green colorblind.
I have seevre inxaety	I have severe anxiety.
The beans ewre delicious.	The beans were delicious.
Tom assassinatqed th Ikng	Tom assassinated the King.
Etom deovr nito ca parked car.	Tom drove into a parked car.
'id gbeen thewre before.	I'd been there before.
Pomeranates are wried	Pomegranates are weird.
Let's jfinish te tirsf season.	Let's finish the first season.
Om is a ca worshiper.	Tom is a cat worshiper.
I'll make it next tmie	I'll make it next time.
Amlka si a good snipe.	Malka is a good sniper.
Ufck btoh f ou!	Fuck both of you!
It'zs nacptime.	It's naptime.
Hcow do you register to eotv	How do you register to vote?
I couldn'jt separate the two.	I couldn't separate the two.
Tom only wears blawck T-oshirts.	Tom only wears black T-shirts.
Teh actiing wassn't great.	The acting wasn't great.
Our plans have one awry.	Our plans have gone awry.
Ton'd letl Tfom I was ere.	Don't tell Tom I was here.
What city are you dfrom?	What city are you from?
That forest iss haunted.	That forest is haunted.
Cokie licked Mot's neso	Cookie licked Tom's nose.
Put eht pipe dow.	Put the pipe down.
I don'bt know; I'm jus a cat.	I don't know; I'm just a cat.
Tobm can't do a pull-up.	Tom can't do a pull-up.
I'm iogng ot let you finish.	I'm going to let you finish.
Gte down off your crossi.	Get down off your cross.
Ctah ot yuor heart's constent.	Chat to your heart's content.
How did he get so hucm money?	How did he get so much money?
Tom has a horseface.	Tom has a horseface.
Om didn't ge a rise.	Tom didn't get a raise.
I'll bt you Tom guets deldyea	I'll bet you Tom gets delayed.
I don't believe Tom overdosed.	I don't believe Tom overdosed.
I don't fuck with olives.	I don't fuck with olives.
It's been way too hot.	It's been way too hot.
Eakt it out of the bxo	Take it out of the box.
Does anyone mcare aout that?	Does anyone care about that?
Sh sgna and he dancaed.	She sang and he danced.
I jufst realized I'm dreaming.	I just realized I'm dreaming.
Little htings agdd u.	Little things add up.
I stood up for myself.	I stood up for myself.
My partners are onnbinary	My partners are nonbinary.
Tyeh must've geno to France.	They must've gone to France.
I am damden	I am damned!
Ji h'venat read that anywhere.	I haven't read that anywhere.
Tseher s a translatoro.	Esther is a translator.
You can qguiz me.	You can quiz me.
He was ea puny man.	He was a puny man.
They're pirates.	They're pirates.
W ahd some xcellent eamrn	We had some excellent ramen.
Iron's atomic umber is 26b.	Iron's atomic number is 26.
Tom smoked uns p.	Tom smoked us up.
Yi knodw Tom knows that I know.	I know Tom knows that I know.
H is working day and nigt.	He is working day and night.
Tom livs n Nostob Ontario.	Tom lives in Boston, Ontario.
You're high.	You're high.
Do tyou lpike cranberry juice?	Do you like cranberry juice?
Od yowu ever sleep, To?	Do you ever sleep, Tom?
They shared an orangke.	They shared an orange.
Shete are't related.	These aren't related.
Tom skippd eg day.	Tom skipped leg day.
Whyy does Tom smll leki that?	Why does Tom smell like that?
These crisps are very moreish.	These crisps are very moreish.
Eat the rih.	Eat the rich.
Cyou wre right abou fthat.	You were right about that.
Tom's cadr was totalled.	Tom's car was totalled.
I refuse to paitrcipate	I refuse to participate.
Here era two tpes fo pide.	There are two types of pride.
Tom exoticizes Judasm.	Tom exoticizes Judaism.
Otm switched banks.	Tom switched banks.
Ei can afix him.	I can fix him.
Erthes disapdointep he fans.	Esther disappointed her fans.
I turned the fafn on.	I turned the fan on.
Dogs have long snouts.	Dogs have long snouts.
A fetus is noht a bab.	A fetus is not a baby.
Di etnd t misinterpret things.	I tend to misinterpret things.
X i ansufe	X is unsafe.
Hme decidd ot go back.	He decided to go back.
What causses waves?	What causes waves?
Ji dreamt I was duoing blow.	I dreamt I was doing blow.
I learned ti on lmpuise	I learned it on impulse.
Tom bought a hedge trimmer.	Tom bought a hedge trimmer.
Tmo conmfessed to everything.	Tom confessed to everything.
Religion jis a funny thing.	Religion is a funny thing.
No eno says mit like tha.	No one says it like that.
Scotland shall be fre.	Scotland shall be free.
Woh knows you tzhe btse	Who knows you the best?
I dn't watnt to eb thsi way	I don't want to be this way.
Ca oyu pcik em uyp t 3?	Can you pick me up at 3?
Is anyone fluehnt in Latin?	Is anyone fluent in Latin?
I lve monkeys.	I love monkeys.
In'm not Myra's eifw	I'm not Mary's wife.
I'm always confused.	I'm always confused.
Bush lied nad people ied.	Bush lied and people died.
I live on Mlars.	I live on Mars.
Eevrybody ghas laws.	Everybody has flaws.
Yiddish si ot Hebrew.	Yiddish is not Hebrew.
Im' a cat fo science.	I'm a cat of science.
Conformity i boring.	Conformity is boring.
Tom is half-dorc.	Tom is half-orc.
Augut is too long.	August is too long.
Can cawts hve sweet pottao	Can cats have sweet potato?
Esth'res back on hr wbullshit.	Esther's back on her bullshit.
I'm a farmer b trade.	I'm a farmer by trade.
Ti was a dick eovm	It was a dick move.
We're worrie about you, Tm.	We're worried about you, Tom.
H lives tuo in th boondocks.	He lives out in the boondocks.
No that, I agree wityh you!	On that, I agree with you!
That was a valid sentence.	That was a valid sentence.
Ddo yu need me to pmove?	Do you need me to move?
Yi'd glike a replacement.	I'd like a replacement.
Pi korw tiwh Tom anpd Mary.	I work with Tom and Mary.
E're kliving osn tsolen land.	We're living on stolen land.
Mot wovuldn't dare.	Tom wouldn't dare.
Tohm must ble sick in the head.	Tom must be sick in the head.
Its lal a farce.	It's all a farce.
Yankev is an obervant Jew.	Yankev is an observant Jew.
You're so uch happie noiw.	You're so much happier now.
'm a line coko	I'm a line cook.
It wsa good to see everyone.	It was good to see everyone.
Ihts way, I aree wih you!	This way, I agree with you!
Record the iolpce	Record the police.
Tom dovesn't wear deodorant.	Tom doesn't wear deodorant.
He's ver self-conscious.	He's very self-conscious.
Tom speaks truth ot power.	Tom speaks truth to power.
Tom refuses to swim.	Tom refuses to swim.
What's a repast?	What's a repast?
Xi eflt eomsthing toucah me.	I felt something touch me.
Trump got raided bwy he Mfbi.	Trump got raided by the FBI.
He's a svnsitiee guy.	He's a sensitive guy.
Uhh I nowder woh that's for.	Huh. I wonder who that's for.
Her emotions were in turmoil.	Her emotions were in turmoil.
Torm is just a luvvy.	Tom is just a luvvy.
They knwo they're wroung.	They know they're wrong.
Reuchel si ma Polish Jew.	Ruchel is a Polish Jew.
That's not suspicious at all.	That's not suspicious at all.
We nee new curtains.	We need new curtains.
Some people are malicious.	Some people are malicious.
Isn't yor frsona a ferret?	Isn't your fursona a ferret?
Its's a ibt muech.	It's a bit much.
Mjy mom is axn excellent cook.	My mom is an excellent cook.
Muary as hyperthyroidism.	Mary has hyperthyroidism.
That's a vald criticism.	That's a valid criticism.
Someone as following em	Someone was following me.
Define quatily	Define quality.
Go ahead adn do eht work.	Go ahead and do the work.
Throw m a bone.	Throw me a bone.
There's a knttei n or porch.	There's a kitten on our porch.
Tom ais a pyromanica	Tom is a pyromaniac.
I havge therlapy today at 23:0	I have therapy today at 2:30.
You won't find that here.	You won't find that here.
That's a tautotlogy.	That's a tautology.
Shoplifting is good.	Shoplifting is good.
Tom's vexation wa evident.	Tom's vexation was evident.
Where is Kayblia	Where is Kabylia?
We'll g nex time.	We'll go next time.
Llet's chaonge the world.	Let's change the world.
T's simply obvious.	It's simply obvious.
I seep in my car.	I sleep in my car.
Om claims hqe was drunk.	Tom claims he was drunk.
I loev ym mums.	I love my mums.
Otm saent his sandwich kacb	Tom sent his sandwich back.
Whly are you so silly?	Why are you so silly?
Tom sis a goblin.	Tom is a goblin.
I loev mxy moms.	I love my moms.
Most people aren't like that.	Most people aren't like that.
File xis but a ream.	Life is but a dream.
Alt least ble tonesh	At least be honest.
Babies are cute.	Babies are cute.
Wht really akes you anmgry?	What really makes you angry?
Ew.	Ew.
I knd fo lzive at thxe library.	I kind of live at the library.
Tom ixs a Finn frdom Rauma.	Tom is a Finn from Rauma.
Otm could've fixed ikt.	Tom could've fixed it.
Go cfor the eyes.	Go for the eyes.
Jackson strikes em sas a hsill	Jackson strikes me as a shill.
It's not time yet.	It's not time yet.
Htom has ADHD.	Tom has ADHD.
I' gray ae.	I'm gray ace.
Trump killed Epstein.	Trump killed Epstein.
Yu wouldn't download a car.	You wouldn't download a car.
Tmo is wa squattler.	Tom is a squatter.
Charity si a virtuke.	Charity is a virtue.
I' in Montana.	I'm in Montana.
Avast	Avast!
Des Tuom ever slep?	Does Tom ever sleep?
Horw can your cat tweet?	How can your cat tweet?
Blasphemy si a humabn right.	Blasphemy is a human right.
Ats cn come.	Cats can come.
Wkhy is Januajry so long?	Why is January so long?
Manny Kabyleas are anot Mumliss	Many Kabyles are not Muslims.
Her tail is cute.	Her tail is cute.
Di love your kitty ears.	I love your kitty ears.
Ew he people aer overwhelmed.	We the people are overwhelmed.
You are a dear.	You are a dear.
Trans women are woen.	Trans women are women.
Spome Muslims ar not tolerat.	Some Muslims are not tolerant.
It's OK; I've got this.	It's OK; I've got this.
I tolld them th same thing.	I told them the same thing.
This may eb out of my depth.	This may be out of my depth.
Tmo si a rel ousybbdy	Tom is a real busybody.
The cat wats to og out.	The cat wants to go out.
T'erehs s mch BS about AI.	There's so much BS about AI.
Mi hyave no permanent resideynce.	I have no permanent residence.
Chauvinism kills.	Chauvinism kills.
You can't just od it!	You can't just do it!
These candles wer Esthers.	These candles were Esther's.
Tom's being Tom.	Tom's being Tom.
Ho do you takse e for?	Who do you take me for?
It's not makding any neiso	It's not making any noise.
Whno's benen texting uoy	Who's been texting you?
Jesu is annoying.	Jesus is annoying.
Tom was very unhaelpful.	Tom was very unhelpful.
Youer' a cat.	You're a cat.
Pisg eat solop.	Pigs eat slop.
I don't dho that stuff.	I don't do that stuff.
Abortion is a huan righ.	Abortion is a human right.
No it won't.	No it won't.
Are uoy still with us, To?	Are you still with us, Tom?
Tom wolud alwys say that.	Tom would always say that.
What's the upshot?	What's the upshot?
Stay out fo the house.	Stay out of the house.
Is't a misnomer.	It's a misnomer.
I'm computer illitnerate.	I'm computer illiterate.
Yes... ha ha ha... yse	Yes... ha ha ha... yes!
You can alwasy call xme.	You can always call me.
Hwo old you t tell Tom?	Who told you to tell Tom?
A stanard byte is eighht bits.	A standard byte is eight bits.
He is tedious.	He is tedious.
Otm tae a fun-sized Mars bar.	Tom ate a fun-sized Mars bar.
Om gisn't antisocial.	Tom isn't antisocial.
I fixed ti ofr youb.	I fixed it for you.
I'm not going to read that.	I'm not going to read that.
Te experience chengad Tom.	The experience changed Tom.
Eon Musk sfhould opay taxe.	Elon Musk should pay taxes.
You're onlsy old oncke.	You're only old once.
He's oto judgmental.	He's too judgmental.
You're a lot of peole's type.	You're a lot of people's type.
Who's your mentor?	Who's your mentor?
Thy will tear yo to pieces	They will tear you to pieces!
Shat't a vgery plaintive meowz.	That's a very plaintive meow.
Hown's txhe new kitte udoing?	How's the new kitten doing?
Copyright is thet.	Copyright is theft.
I tkinh yoiu're angry!	I think you're angry!
Estoher is mgkina challah.	Esther is making challah.
The ral Jews re eht Sewj	The real Jews are the Jews.
Try t distract yoursel.	Try to distract yourself.
Puri i a fun holiday.	Purim is a fun holiday.
Tom gvae intjo pree pressure.	Tom gave into peer pressure.
Cufk the patriarch.	Fuck the patriarchy.
Tom i eighet feet tall.	Tom is eight feet tall.
What's eating you up?	What's eating you up?
Ti ws all done ut of animus.	It was all done out of animus.
I did not undertand aneything.	I did not understand anything.
Ahppy Quinox!	Happy Equinox!
Make fascists aofraid agian	Make fascists afraid again.
Sorry I alopogize so vmuch.	Sorry I apologize so much.
I sedll btaskets.	I sell baskets.
List two pet peeves.	List two pet peeves.
Si canrh dressing healthy?	Is ranch dressing healthy?
Chauvinism is toxic.	Chauvinism is toxic.
That mutt bit yme!	That mutt bit me!
Ltom disn't exactly n acsetic	Tom isn't exactly an ascetic.
Tom's gtten so tall.	Tom's gotten so tall.
House centipedes avoid people.	House centipedes avoid people.
I ws in the wrong.	I was in the wrong.
An wlaeth saved conts.	Any wealth saved counts.
Stay on teh rail.	Stay on the trail.
Cats have small noses.	Cats have small noses.
Tom is a man of learning.	Tom is a man of learning.
'm sa fairy prsnceis	I'm a fairy princess.
I've goxt ebats for brains.	I've got bats for brains.
Is father is plite.	His father is polite.
Wha are you hidng, pedo?	What are you hiding, pedo?
Ftom was in a funk.	Tom was in a funk.
Fiddlesticiks!	Fiddlesticks!
Dot'n talk to th polifce.	Don't talk to the police.
Tm relapsed agnia	Tom relapsed again.
I sell baked goods	I sell baked goods.
Upates ae ready ot install.	Updates are ready to install.
Who is this cnowl	Who is this clown?
Not yu, Tom. Anther Tom.	Not you, Tom. Another Tom.
Ym fork i to small.	My fork is too small.
Yep, ethat's right.	Yep, that's right.
You're da op.	You're a cop.
He ad Si are aregt friends.	He and I are great friends.
To ate ni his car.	Tom ate in his car.
I don't leki quality.	I don't like quality.
Is te Caspian Seha a lake?	Is the Caspian Sea a lake?
We smashed.	We smashed.
I clla m knife "Tom.	I call my knife "Tom."
Yarm and Alice do burlesque.	Mary and Alice do burlesque.
Gi do not know who h is.	I do not know who he is.
That's intinct.	That's instinct.
Thaqt was my grandp.	That was my grandpa.
I'll egt ehr some milk.	I'll get her some milk.
I'm chypomanic.	I'm hypomanic.
I tink pfigs ar adorable.	I think pigs are adorable.
Th real groomers are priests.	The real groomers are priests.
Tom took my seat.	Tom took my seat.
How kfar waay iqs �so Paulo?	How far away is S�o Paulo?
What the sit ws tat?	What the shit was that?
He ids bable tbo shing.	He is able to sing.
I hear Tom wis aa euicjr	I hear Tom is a juicer.
This dude si a genius.	This dude is a genius.
Ynni and Sami shotuld ook up.	Yanni and Sami should hook up.
Ci dont speak Tirkush	I don't speak Turkish.
He was a cmmunist arebel.	He was a communist rebel.
One down, two to og	One down, two to go.
Anxiety overwhels usj.	Anxiety overwhelms us.
Leave your drama at the door.	Leave your drama at the door.
Rhow's Tom likgni Boston	How's Tom liking Boston?
Wtah da crok!	What a crock!
I know Tom knows I kwon	I know Tom knows I know.
It's cloggedz.	It's clogged.
Swap i out fr a ew one.	Swap it out for a new one.
Tom has va weekly jradio fshow.	Tom has a weekly radio show.
Wtah's the capitatl fo Egypt?	What's the capital of Egypt?
Mary is Alice's wife.	Mary is Alice's wife.
That Otm jis qa bad influence.	That Tom is a bad influence.
They're not prepared.	They're not prepared.
Submit only your bets workf.	Submit only your best work.
Gros.	Gross.
For once, Tom saw riight.	For once, Tom was right.
He lookd like a dead body.	He looked like a dead body.
I love moy spose.	I love my spouse.
The light's oo diim.	The light's too dim.
Lojzban is cuteo.	Lojban is cute.
M bod blongs to me.	My body belongs to me.
Hey were correct.	They were correct.
Happy Neuw Year 2022/2972!	Happy New Year 2022/2972!
Ai love the Kabyle flag.	I love the Kabyle flag.
They worship Asqhtoreth.	They worship Ashtoreth.
I woluld love to lhear it.	I would love to hear it.
Sh's asleep.	She's asleep.
I'm going to throw it out.	I'm going to throw it out.
Coffee ois life.	Coffee is life.
They aswayl head htere	They always head there.
Is pneumoni lcontagious?	Is pneumonia contagious?
Mot used to do drugs.	Tom used to do drugs.
Puase it.	Pause it.
I'd like to uxse tese coupons.	I'd like to use these coupons.
Ybou deserve happiness.	You deserve happiness.
Who owns youdr pilitocian	Who owns your politician?
Our soldest act turned 18.	Our oldest cat turned 18.
Pop the hood	Pop the hood.
Bwe usd to be parts fo stars	We used to be parts of stars.
Prut yyour cap on your heead.	Put your cap on your head.
That noesd't look strdy.	That doesn't look sturdy.
Tke a book or elave a ook.	Take a book or leave a book.
Odo you have a spare stire?	Do you have a spare tire?
Il'tl be ta couple vof monpths.	It'll be a couple of months.
'm a fzormer urdg addict.	I'm a former drug addict.
Re you on Tom's tem?	Are you on Tom's team?
It's like an appetizer.	It's like an appetizer.
Tom changed ihs pnumber.	Tom changed his number.
H's a Sephardi Jetw.	He's a Sephardi Jew.
Toom strummed the guitar.	Tom strummed the guitar.
Communism will win!	Communism will win!
Urn the flag!	Burn the flag!
Feelinpgs aren't feacts.	Feelings aren't facts.
T stopped turning on	It stopped turning on.
Ti think Tom is a icat.	I think Tom is a cat.
Tom stepped o the ga.	Tom stepped on the gas.
My stuff doesn't sel tehre	My stuff doesn't sell there.
Boo!	Boo!
Tm ws born on Mars.	Tom was born on Mars.
Midwesterners ylive n sarmf	Midwesterners live on farms.
Merry Mary, marry me.	Merry Mary, marry me.
Fre Occitania!	Free Occitania!
Whast would Qtom od ni Boston?	What would Tom do in Boston?
That seefms kind fo eird.	That seems kind of weird.
Od uoy tihink 'ehs cute?	Do you think he's cute?
Nelver tae sihredded wheat.	Never eat shredded wheat.
Is tomato sauce healtkhy?	Is tomato sauce healthy?
Tohm was chuffed two tibs	Tom was chuffed to bits.
This pzzia is learny perfect.	This pizza is nearly perfect.
Hi, Satan	Hi, Satan!
Tom's tusj rouy average Joe.	Tom's just your average Joe.
What era we having?	What are we having?
Arne there gay fiqsh?	Are there gay fish?
Kabyle is a Erber language.	Kabyle is a Berber language.
I ell dope.	I sell dope.
Tmo is na antpropomorhhic cat.	Tom is an anthropomorphic cat.
I love hamsters.	I love hamsters.
Wtna xa sp?	Want a sip?
Petople are wildw.	People are wild.
Iobilnty is wa scam.	Nobility is a scam.
I had top surery.	I had top surgery.
Tom si  cpackage thief.	Tom is a package thief.
Tring ttheory isn't texstable.	String theory isn't testable.
There's nothin good on	There's nothing good on.
People are silly.	People are silly.
Peanut buthter is a mealk.	Peanut butter is a meal.
Wat ot split ha pizza?	Want to split a pizza?
Tmo called a locksmith.	Tom called a locksmith.
Si there sjilicon-based lifoe?	Is there silicon-based life?
Tm would do that rof free.	Tom would do that for free.
Mina refusevs ot comprjomise.	Mina refuses to compromise.
Captalism is coercive.	Capitalism is coercive.
Rae you callling me a ommie?	Are you calling me a commie?
Fi reprimanded im wlle	I reprimanded him well.
I love cuddling.	I love cuddling.
Progress is ton inevitable.	Progress is not inevitable.
I spent th whole ay there.	I spent the whole day there.
Why ddi apes lose our tlias	Why did apes lose our tails?
How far away is Toakyo?	How far away is Tokyo?
Afre the camers rgllino	Are the cameras rolling?
Tm is a Pastafarian.	Tom is a Pastafarian.
Fascism i ni fuhll swing.	Fascism is in full swing.
Thaw a funny coincidence.	What a funny coincidence.
Ri si agender.	Ari is agender.
Wfhat pharmacies arhe neariby?	What pharmacies are nearby?
I am that sleepy.	I am that sleepy.
Talk to yuo soon.	Talk to you soon.
Tom'ws charactger si a paladitn.	Tom's character is a paladin.
It's xtoo crinige o e fake.	It's too cringe to be fake.
Im going tvo caffeiante	I'm going to caffeinate.
I'm hungry feor your words.	I'm hungry for your words.
Oof.	Oof.
Ow does atnip work?	How does catnip work?
It's genuinely pathetbic.	It's genuinely pathetic.
This is Ttom's cell.	This is Tom's cell.
Do lack holes lead anywhere?	Do black holes lead anywhere?
There were obnly two nem	There were only two men.
Some pelpoe fight bajck.	Some people fight back.
Ceck the answer key.	Check the answer key.
I woudl nevebr.	I would never.
My punxch didn't land.	My punch didn't land.
Tom is hyperlexic.	Tom is hyperlexic.
Roger Waters should ptos	Roger Waters should stop.
Raise the oof!	Raise the roof!
What are yowu nskiag rof it?	What are you asking for it?
I'll never yunderstand it.	I'll never understand it.
Have you evr ben o Kmabylia?	Have you ever been to Kabylia?
I'm ton fluent in Cat.	I'm not fluent in Cat.
The cast are upst.	The cats are upset.
I've never eaen seaweedq.	I've never eaten seaweed.
How's everythng? "Horrible."	How's everything? "Horrible."
Stay no guard!	Stay on guard!
Israel is oa beautiul country.	Israel is a beautiful country.
Acts thitcw uring REM sleep.	Cats twitch during REM sleep.
My cat si ran damant Maoist.	My cat is an adamant Maoist.
Are boarrs fat	Are boars fat?
Ro Paul awill mwake anime real.	Ron Paul will make anime real.
Oesther aws born on a kibbutz.	Esther was born on a kibbutz.
I's a very relaxing place.	It's a very relaxing place.
I osell grills.	I sell grills.
Mkary's bay is lguy	Mary's baby is ugly.
I'm reloading.	I'm reloading.
That horse can tkla	That horse can talk.
Do'nt tyr o befriend a bar.	Don't try to befriend a bear.
Didn't Tom udes t say that?	Didn't Tom used to say that?
Dmy caer neyeds fixend.	My car needs fixed.
He dgid not say a single rowd	He did not say a single word.
It has to be pthese ones.	It has to be these ones.
It'ks in hte attic.	It's in the attic.
I'll typ more baout it later.	I'll type more about it later.
Wha sort gof trickery is this?	What sort of trickery is this?
Th tom's namde is Ztom.	The tom's name is Tom.
None of them belong tzo e.	None of them belong to me.
Is tthis yuor pot-bellied pg?	Is this your pot-bellied pig?
Tom jand Mary are polyamorous.	Tom and Mary are polyamorous.
A threat si not a wrldview.	A threat is not a worldview.
Torm is nice axs pie.	Tom is nice as pie.
Tom knows he's wrong.	Tom knows he's wrong.
Pigs are very smargt.	Pigs are very smart.
Ill' cut you a aedl	I'll cut you a deal.
Children are peoxple.	Children are people.
It's not worth it, Om.	It's not worth it, Tom.
Look! These rae yoyur bothers!	Look! These are your brothers!
The turtle's asleep.	The turtle's asleep.
Nobody invited Twom.	Nobody invited Tom.
It was a joyous celebration.	It was a joyous celebration.
I'm goinkg on a unger storike.	I'm going on a hunger strike.
Play Freebird!	Play Freebird!
No aumhn being eis illegal.	No human being is illegal.
Was Tom one ouf he Jackson 5?	Was Tom one of the Jackson 5?
I hate this tcime of eyar	I hate this time of year.
Drink kme.	Drink me.
Tom's wering jeans.	Tom's wearing jeans.
I should gt goign soon.	I should get going soon.
How fr away is Lagos?	How far away is Lagos?
